'meta w 40 h 40 "first_map"

'layer animals
11 11 13 14 12 14 14 10 10 14 13 13 13 13 10 10 14 13 10 13 14 11 11 11 10 11 12 10 10 14 11 13 14 13 14 13 13 14 11 12
10 11 10 12 12 13 10 12 12 14 12 14 12 12 11 14 13 10 11 10 10 13 13 13 12 10 11 12 14 13 12 10 14 10 11 11 10 10 11 11
14 13 11 14 11 10 11 14 13 13 13 10 10 11 14 14 11 12 10 13 10 11 11 14 13 12 10 13 11 13 10 10 14 14 12 14 12 13 11 13
13 13 11 12 12 14 10 13 14 14 10 10 14 14 13 12 14 13 14 14 12 10 14 12 11 13 11 14 11 12 13 12 10 10 12 12 11 12 12 13
14 10 14 10 11 11 14 13 13 10 11 12 11 11 14 12 12 10 11 12 13 14 10 10 11 10 13 13 10 10 11 13 14 13 12 10 10 10 13 12
11 11 14 10 11 12 10 11 11 10 14 12 10 12 10 12 10 13 10 10 13 14 12 10 13 13 13 13 12 12 11 13 14 10 11 14 10 10 12 11
10 12 11 14 11 14 12 14 13 10 10 14 10 11 10 13 14 14 10 12 10 12 11 13 13 14 14 13 13 12 13 10 14 11 11 13 14 13 11 14
12 14 11 13 11 10 13 10 11 13 11 10 12 11 13 10 13 10 12 12 13 12 12 12 11 11 10 10 13 13 12 11 10 10 13 14 12 11 14 14
11 13 12 14 14 14 10 13 10 12 14 12 11 14 10 11 12 13 11 11 12 10 14 10 14 13 13 13 10 11 14 13 12 13 14 13 14 12 11 13
14 12 11 14 11 10 10 13 11 14 13 14 10 12 10 14 14 10 13 11 11 11 12 10 13 11 10 13 13 12 14 14 10 11 14 14 13 13 14 14
11 12 11 13 12 11 11 12 12 12 12 12 14 11 14 11 13 13 11 13 10 12 12 10 12 12 12 10 13 11 14 11 14 12 14 10 10 10 13 13
11 12 10 14 14 14 12 10 12 12 13 10 12 11 11 11 13 13 12 10 14 13 12 10 13 10 10 11 13 11 10 12 12 13 12 12 11 12 13 13
10 13 13 12 10 13 11 14 14 12 14 12 10 14 12 12 14 10 13 10 14 11 10 10 13 10 14 14 10 14 12 12 13 10 12 10 13 14 11 12
14 11 14 10 10 13 14 14 12 12 10 13 10 13 11 12 13 12 10 13 10 13 11 14 13 13 11 13 12 10 12 11 10 11 13 14 13 10 14 13
13 14 10 10 11 11 12 10 10 12 14 11 10 12 10 10 11 12 13 13 13 12 13 14 11 12 14 14 10 12 10 12 10 14 14 11 14 14 10 12
13 13 10 11 12 11 14 11 13 11 11 12 12 10 12 11 13 13 11 14 13 12 11 14 13 14 11 12 11 10 12 14 12 13 13 11 12 10 10 13
12 11 14 13 14 14 10 12 12 12 13 11 10 12 11 12 14 11 13 11 11 14 14 10 12 11 12 11 11 11 11 12 11 10 10 12 10 14 12 10
12 10 11 11 12 10 10 14 10 10 13 11 11 11 11 13 12 12 13 10 10 14 11 12 14 12 13 14 14 12 10 11 14 12 11 11 10 11 14 14
10 13 14 10 12 14 11 12 14 11 14 11 14 14 13 12 13 14 14 14 11 12 10 14 12 11 12 13 14 13 14 12 11 13 12 13 11 12 10 12
14 14 12 14 12 11 12 14 10 13 11 10 11 14 11 10 10 14 11 12 10 11 10 13 14 11 10 12 14 12 10 12 12 11 12 10 14 13 12 13
10 13 13 11 11 14 10 11 13 10 13 13 12 11 14 12 11 13 12 10 14 11 14 12 13 10 13 12 10 12 14 14 14 13 14 14 13 11 13 13
11 14 14 11 11 12 14 12 11 11 12 14 13 10 14 11 12 14 12 13 11 14 13 11 14 14 11 10 10 14 14 12 13 11 13 12 11 13 11 13
13 14 12 13 13 14 14 13 14 14 10 13 14 10 13 10 13 10 14 13 13 11 11 12 12 14 14 13 11 12 11 14 10 13 12 14 10 12 13 12
10 12 10 12 10 13 10 12 14 10 11 11 14 11 10 10 12 11 13 11 11 12 12 14 10 14 14 10 13 11 12 13 14 11 13 10 13 14 10 11
11 12 10 13 14 14 11 12 11 13 12 14 13 10 12 11 11 11 14 14 11 11 14 10 11 14 14 13 10 11 12 12 14 12 12 11 10 14 14 13
11 11 14 13 10 13 14 10 13 12 11 13 10 12 12 12 13 14 13 13 13 12 14 11 14 10 13 13 13 10 14 14 13 13 12 12 10 14 14 12
13 13 11 11 13 11 13 14 13 13 13 13 13 14 11 14 14 10 14 10 10 11 11 11 12 13 14 11 11 12 11 13 11 12 11 13 14 13 13 14
10 13 11 14 10 12 11 13 13 14 10 13 13 14 13 13 11 10 12 13 13 12 10 14 13 11 12 14 12 13 13 10 11 10 12 12 12 11 11 11
13 10 12 11 14 14 10 10 14 11 10 14 11 14 12 13 12 13 12 12 14 12 14 12 12 13 13 14 10 13 12 10 14 10 13 10 14 10 13 12
10 11 12 12 13 12 13 14 13 11 13 12 10 11 14 11 13 14 13 12 11 12 13 10 11 12 14 12 12 12 13 12 12 11 11 14 10 10 14 11
11 12 11 12 12 13 14 13 14 13 14 11 10 10 10 12 10 11 12 10 13 13 11 14 14 10 12 13 14 13 12 12 10 12 10 12 13 10 13 12
10 10 12 13 10 12 12 13 10 11 14 11 14 10 14 11 11 10 11 11 11 12 13 11 12 11 13 11 11 12 11 12 14 13 10 13 14 11 11 14
11 13 12 12 10 13 13 11 13 14 14 11 10 11 13 10 12 13 14 10 10 12 11 10 10 10 11 10 12 12 13 14 12 11 13 12 11 13 11 14
10 13 10 10 14 14 12 14 14 11 12 12 11 10 14 14 14 10 10 13 10 10 10 14 13 12 14 11 14 14 11 11 10 11 14 12 11 11 10 10
13 11 14 14 14 10 13 11 10 13 10 11 11 10 12 10 14 10 13 14 11 12 12 12 14 13 13 13 12 13 10 14 10 14 10 12 11 10 10 11
12 13 12 14 13 12 14 13 10 11 12 12 11 12 14 11 13 11 13 12 11 11 10 13 10 11 13 11 12 13 14 14 14 12 10 14 12 12 14 13
13 13 11 11 12 13 14 11 11 11 14 13 13 10 12 13 11 13 14 13 11 14 14 13 14 11 12 12 14 14 10 14 14 13 11 13 11 14 11 11
13 13 14 11 10 13 13 11 12 14 12 13 13 11 10 12 14 10 14 10 11 11 11 11 11 14 10 10 10 11 11 13 13 10 13 14 14 13 12 14
10 10 11 11 12 11 12 13 14 14 10 12 14 14 11 14 10 13 10 14 13 14 13 14 12 13 14 12 14 10 10 14 12 11 10 11 11 10 12 12
10 10 12 14 10 10 12 10 13 11 11 10 11 13 10 12 13 12 13 11 11 12 10 13 12 14 12 10 12 12 11 12 13 13 12 14 13 10 13 13

'layer ground1
1 2 3 3 2 4 4 1 3 3 0 2 0 4 4 1 0 0 0 0 3 4 2 0 1 1 3 0 2 4 3 4 3 4 0 2 4 1 4 2
0 1 1 0 4 0 3 0 4 0 0 2 4 1 0 0 1 4 1 2 1 0 0 0 3 1 0 2 4 0 2 1 2 0 3 1 1 3 2 4
3 4 0 1 2 2 1 3 3 4 4 0 0 1 0 4 1 0 3 2 0 1 4 1 0 4 3 3 0 1 1 4 0 4 4 1 4 4 2 4
1 3 0 0 2 3 3 4 4 0 3 1 0 3 1 2 2 1 4 4 2 4 3 1 0 1 1 2 3 0 2 4 4 4 4 2 2 0 3 1
1 4 0 2 1 3 1 4 2 1 2 0 0 3 4 4 2 0 4 0 3 4 0 3 0 0 2 1 0 2 4 1 3 0 2 0 3 4 4 2
0 0 3 2 4 3 2 2 2 4 2 4 0 1 1 3 1 2 2 2 1 1 4 2 1 4 1 2 3 0 0 0 4 0 4 0 1 3 4 0
2 4 0 2 1 1 4 1 0 2 1 0 3 4 2 1 3 1 3 1 3 3 0 2 1 0 2 2 3 3 1 0 4 1 3 0 0 2 3 3
3 4 2 0 0 0 2 2 3 2 1 2 0 3 4 3 4 0 4 0 0 4 4 4 0 1 3 2 2 2 4 0 1 4 3 2 3 0 3 3
1 3 2 2 3 3 1 0 3 2 4 1 2 2 3 2 0 1 0 1 4 0 4 2 4 3 0 0 1 4 4 4 3 3 0 1 3 2 3 1
3 4 2 1 1 3 4 1 4 2 4 4 1 0 3 0 4 1 3 4 1 3 0 1 0 0 1 0 0 4 2 0 0 0 2 0 4 3 2 4
2 4 4 3 4 2 2 3 3 2 1 2 0 0 1 1 4 0 3 0 3 3 1 3 2 0 3 1 3 1 2 0 3 2 4 0 0 4 4 2
2 1 1 0 0 4 4 3 1 1 4 1 3 0 2 4 0 3 1 1 2 4 3 1 0 3 4 2 1 4 1 4 1 1 4 1 0 4 3 2
2 0 2 0 1 0 2 4 3 4 3 4 3 1 1 3 2 2 2 4 1 1 1 4 0 4 3 0 4 4 2 0 3 0 0 3 1 1 1 3
0 0 2 4 3 4 2 3 4 1 1 1 4 0 1 3 1 3 2 1 1 0 4 4 3 2 2 3 4 1 2 0 3 0 3 3 3 4 0 1
2 1 3 4 0 4 3 1 1 1 4 3 0 0 3 3 4 3 2 2 2 3 2 4 4 1 1 2 4 0 3 3 1 3 4 0 0 0 2 0
3 2 1 2 1 1 3 2 3 4 1 0 2 4 2 3 2 4 3 4 3 0 3 3 1 3 3 0 1 1 0 1 0 2 0 1 4 0 3 0
0 3 3 4 3 4 3 4 2 1 1 4 2 1 0 1 4 4 2 0 0 3 2 2 0 1 0 1 0 4 0 3 0 4 3 0 1 2 1 0
3 1 1 1 3 3 4 4 2 2 2 3 1 0 1 1 1 4 1 0 3 3 1 3 4 2 3 2 4 4 1 2 4 1 2 3 0 0 0 1
1 4 1 0 2 0 1 2 2 4 1 0 1 1 4 3 0 0 1 3 3 3 0 0 4 1 0 0 4 1 3 0 4 4 1 0 3 2 3 2
2 0 2 2 0 4 1 1 2 3 3 2 3 3 1 4 2 1 0 0 4 2 4 0 2 4 3 4 2 4 2 3 1 1 4 1 0 0 4 1
3 2 0 2 3 1 4 3 2 0 3 1 1 0 2 0 1 2 3 0 3 4 0 3 0 1 4 2 2 3 0 2 3 2 1 4 3 1 3 1
4 0 4 0 4 1 0 1 2 4 3 1 4 2 3 3 0 2 0 1 1 0 3 1 3 4 0 0 3 1 1 3 3 2 0 3 2 1 0 2
3 1 3 3 3 1 3 0 1 0 4 2 1 2 4 1 1 3 3 2 2 0 2 3 3 3 4 0 2 2 3 4 0 0 3 0 0 3 0 0
0 4 0 0 4 3 4 3 3 2 0 3 0 3 2 1 4 3 4 3 3 2 4 2 1 4 4 3 3 1 0 3 1 4 2 2 0 0 4 2
0 2 2 2 1 0 1 0 2 4 2 2 4 2 4 1 1 3 1 2 2 3 1 4 0 0 0 0 4 2 1 2 2 4 4 2 3 4 4 3
3 1 0 2 1 4 4 4 4 2 4 2 0 2 1 3 4 3 3 2 3 1 2 0 3 2 1 0 2 2 1 0 0 1 4 2 2 3 3 0
4 1 4 1 4 4 2 3 0 1 2 2 2 0 0 3 4 4 2 1 4 0 1 2 4 0 1 2 3 3 4 3 0 2 3 1 1 3 3 2
3 4 4 3 2 1 1 4 4 3 3 0 1 0 3 0 0 2 4 0 4 3 4 1 3 4 0 0 3 3 3 1 4 2 4 0 3 1 4 2
1 4 4 1 2 4 3 1 1 3 1 2 4 0 2 4 0 0 3 1 0 0 3 0 3 0 3 3 2 0 4 0 1 4 0 2 4 0 4 3
2 1 3 3 2 2 0 2 0 4 3 0 4 4 4 2 0 4 1 1 0 3 1 1 0 1 2 3 3 3 3 0 1 4 3 4 4 4 0 4
0 0 0 0 2 1 3 1 0 3 1 2 1 2 2 2 4 0 3 2 4 2 3 2 0 2 4 2 0 0 1 3 1 2 1 0 2 4 0 2
4 4 4 4 0 0 2 1 0 1 4 0 0 2 4 1 1 2 3 4 2 0 1 2 3 3 0 1 0 4 1 2 0 0 3 0 3 1 4 3
2 2 1 2 0 0 2 4 3 1 1 1 0 2 0 4 2 4 0 1 3 3 1 1 3 2 2 3 1 0 0 1 2 2 2 0 3 4 0 3
1 1 2 2 2 4 4 1 4 4 0 0 2 2 1 0 3 1 3 4 1 1 0 0 2 2 2 3 3 0 2 3 2 1 1 4 0 4 0 0
1 1 4 4 1 0 3 4 1 3 4 2 1 0 1 3 2 3 1 1 0 0 3 3 3 1 0 1 3 0 4 1 0 3 4 0 3 0 1 4
1 3 2 2 3 4 0 0 1 4 0 4 2 2 4 3 4 2 1 1 0 2 2 2 1 0 1 2 3 0 2 4 0 0 2 3 4 4 3 3
4 1 1 1 0 3 2 4 3 4 2 1 0 1 3 3 3 0 1 1 0 1 4 2 3 4 3 2 1 3 1 1 0 4 2 2 0 0 4 0
1 3 4 3 1 0 1 0 0 1 2 3 0 1 1 0 1 4 1 1 0 0 4 2 4 1 1 0 2 1 4 2 1 0 0 1 0 1 3 3
3 3 0 4 0 1 3 2 2 4 1 1 1 3 0 2 1 3 4 0 1 0 2 3 0 0 4 2 4 4 2 3 4 1 2 2 3 0 0 3
2 2 1 4 3 2 4 1 1 1 4 0 2 4 1 1 1 0 1 0 1 2 2 2 0 4 2 2 1 2 3 3 3 0 0 1 3 1 4 0

'layer ground2
3 0 2 3 3 4 2 4 2 4 3 4 3 1 4 1 2 1 4 2 1 2 3 1 3 4 1 0 1 0 2 1 3 1 2 2 3 4 3 3
3 2 2 0 3 2 1 2 0 0 4 2 1 2 4 2 3 4 2 1 3 4 4 2 2 1 3 0 4 3 0 1 1 4 4 1 2 2 3 4
1 2 4 4 2 2 2 1 4 3 3 4 4 4 2 1 3 2 2 0 1 4 0 1 1 1 4 2 3 4 1 2 2 0 0 3 1 1 4 3
4 0 2 2 0 3 1 2 1 1 0 3 1 3 1 1 2 4 3 3 3 1 0 2 1 0 4 2 1 4 2 1 3 0 1 1 0 2 2 0
0 1 4 4 2 3 1 4 4 4 1 2 4 3 0 1 4 0 1 2 0 0 3 2 3 4 0 1 3 0 4 2 3 0 0 3 3 3 0 3
2 2 3 1 3 2 3 4 1 0 3 4 2 3 3 4 0 0 2 0 0 0 0 4 3 2 1 4 0 0 4 0 2 1 1 2 0 3 2 0
1 3 1 2 3 1 0 4 4 2 0 4 0 3 3 3 4 2 0 4 4 2 0 0 4 1 4 1 2 3 2 1 0 1 2 1 3 2 2 4
1 0 1 4 1 3 0 4 3 3 2 3 1 2 0 0 2 2 0 3 1 2 1 4 1 1 0 3 1 0 1 2 1 0 0 0 1 3 0 2
1 2 0 3 1 4 2 1 3 2 4 0 0 0 3 2 2 3 0 4 1 4 3 0 1 0 2 0 0 4 3 2 0 1 4 4 4 0 2 2
2 0 0 2 3 2 2 3 4 4 4 4 2 3 3 4 0 1 1 0 2 0 0 3 2 2 3 3 2 4 2 1 4 1 2 2 3 2 0 3
3 2 4 4 0 3 0 0 1 0 2 1 2 2 3 1 3 3 0 1 4 2 4 3 4 3 4 1 4 0 1 1 0 2 2 1 1 1 3 1
4 4 4 1 4 1 2 1 0 3 1 2 4 3 4 2 2 2 2 4 4 4 0 3 3 0 3 3 1 1 1 2 1 1 4 2 1 4 0 1
3 2 0 0 0 4 1 0 0 3 1 0 3 2 2 0 2 0 3 4 4 3 0 2 2 3 1 2 1 4 3 2 4 4 1 1 3 2 1 0
3 4 1 4 4 2 2 2 4 4 2 0 4 4 3 4 4 1 1 2 1 2 0 3 1 0 1 1 0 3 3 1 2 2 1 2 2 3 3 4
2 0 1 1 4 0 0 4 2 4 0 0 2 3 4 2 2 1 4 1 4 4 3 1 2 4 2 3 2 0 1 0 0 2 4 0 4 2 2 2
0 4 1 4 0 4 3 2 2 3 0 4 4 2 2 1 0 1 4 1 3 0 3 2 1 1 2 3 2 2 0 4 0 1 3 0 0 1 4 0
1 3 4 1 4 0 1 4 1 3 1 4 3 1 0 0 1 4 2 1 1 3 3 0 3 1 2 2 2 4 2 0 4 0 3 2 3 1 2 4
4 3 1 2 1 2 3 3 4 1 4 4 0 2 0 2 2 3 1 0 0 3 3 2 3 0 4 2 2 3 2 4 2 2 0 4 2 3 1 0
1 3 1 2 4 2 1 2 2 0 1 2 1 1 4 2 1 4 3 4 4 3 1 3 4 4 2 4 0 0 0 2 4 4 0 2 4 4 1 2
0 4 4 0 1 4 4 3 3 3 2 1 3 2 4 2 4 3 3 1 3 2 2 2 1 4 4 0 1 1 0 4 2 4 0 0 0 2 3 0
2 3 1 1 1 3 0 0 3 1 3 3 3 3 1 4 4 1 0 3 4 1 3 1 2 3 0 1 0 4 0 3 2 3 3 4 3 4 2 3
4 3 1 2 3 4 2 4 0 4 3 1 0 4 0 4 1 2 2 2 4 3 2 3 2 2 3 1 1 4 3 2 1 2 3 1 3 3 0 2
0 3 4 3 1 1 0 1 4 4 3 0 3 2 0 0 1 4 2 2 3 3 2 4 2 2 3 2 4 4 2 2 2 2 0 3 1 3 3 0
2 4 1 0 3 4 4 3 2 1 3 0 4 2 3 3 0 2 1 4 2 4 4 4 2 2 3 1 0 2 1 3 3 0 2 1 2 4 3 1
1 1 3 3 3 4 4 2 2 0 0 4 3 0 3 0 2 2 4 0 2 1 2 4 3 1 2 2 4 1 3 4 1 4 0 0 3 4 3 2
1 4 4 1 1 2 0 2 3 3 4 2 1 2 1 0 2 4 1 1 1 0 2 4 2 4 4 1 2 2 4 1 2 1 2 1 3 4 1 3
3 1 2 2 0 1 0 2 3 3 0 1 1 4 2 2 4 1 0 3 1 1 1 2 0 1 0 0 4 3 3 1 3 2 2 3 2 3 2 1
1 1 1 3 2 3 2 3 2 1 1 4 2 3 2 1 2 4 0 1 4 1 4 2 4 2 1 3 0 1 1 3 0 2 2 4 1 0 0 2
3 4 0 0 4 2 2 1 4 4 1 2 0 2 0 3 2 1 0 0 0 0 1 2 4 0 2 4 4 3 3 4 1 3 4 3 3 1 4 3
4 3 3 1 2 3 0 3 4 4 0 3 4 4 2 2 2 1 0 2 3 0 2 1 0 2 0 4 4 2 1 2 0 2 0 1 2 2 4 3
0 0 4 2 2 2 4 2 2 4 0 1 1 4 1 2 0 4 4 1 1 3 3 0 0 2 4 2 3 4 4 3 4 3 2 3 1 4 3 2
4 3 4 1 2 1 1 0 0 0 4 2 0 1 2 4 1 2 0 3 3 3 0 1 3 4 1 1 0 2 2 2 4 0 1 3 1 0 1 1
4 4 0 0 0 0 0 4 1 4 4 1 0 4 2 4 4 0 4 0 0 4 1 0 3 0 1 3 2 1 2 1 2 3 4 2 4 4 1 3
4 1 3 3 3 0 2 2 3 3 2 4 2 0 3 4 2 0 4 2 0 3 2 4 4 0 2 4 1 2 4 2 0 0 4 4 1 1 1 0
2 1 2 0 4 3 3 3 0 4 0 3 2 2 3 2 1 0 1 1 0 3 1 4 2 3 4 0 4 0 0 4 3 3 3 4 4 3 4 0
4 1 1 2 1 2 3 0 0 4 2 0 3 2 1 3 4 4 4 2 0 0 3 3 2 1 3 1 1 4 3 3 2 2 4 0 4 2 0 3
2 2 3 1 1 4 0 0 4 3 1 1 2 4 2 1 3 4 0 1 4 2 0 2 0 3 3 2 3 0 3 0 3 4 0 4 2 4 0 0
2 3 0 4 3 3 1 4 3 2 0 2 2 4 4 1 0 4 4 0 0 4 3 1 0 3 4 2 4 4 0 3 3 2 4 2 0 2 3 3
4 1 3 4 4 1 4 4 2 4 4 3 2 4 3 0 1 1 0 2 0 2 2 4 2 3 2 1 4 1 0 0 3 3 3 2 3 3 3 2
1 0 2 0 0 0 0 4 2 4 1 2 3 0 2 2 0 4 4 4 2 0 1 4 0 4 1 3 3 4 3 4 2 2 3 0 3 3 0 3

'layer ground3
4 3 3 0 3 2 0 3 4 0 4 4 3 1 4 4 4 2 0 3 0 0 2 1 1 3 3 4 0 1 1 3 1 2 2 1 1 2 4 2
1 1 0 2 4 2 3 1 3 4 3 3 1 2 2 2 3 3 4 0 2 4 4 0 4 4 2 3 1 4 2 3 0 1 1 2 1 1 2 3
1 1 1 3 3 3 3 3 2 1 3 3 2 3 4 4 4 0 1 0 4 3 1 2 3 1 1 1 3 3 2 1 1 0 2 0 4 3 0 0
1 4 4 1 3 2 1 3 3 1 2 2 3 2 4 3 2 0 4 2 2 0 0 0 2 3 0 0 0 2 1 4 3 3 3 1 0 0 1 3
3 3 3 0 0 0 1 2 3 1 3 3 0 4 0 4 3 1 1 2 3 0 1 1 0 1 0 0 1 2 3 4 2 1 0 3 4 2 0 2
1 4 0 1 4 4 4 0 0 2 4 4 2 0 3 1 3 2 3 1 0 3 3 2 4 1 2 2 0 4 3 3 3 0 0 1 3 0 3 2
2 2 2 1 4 1 2 4 1 3 4 3 1 2 1 2 3 2 3 3 3 0 3 2 3 2 1 0 0 1 4 2 4 1 0 2 1 0 2 3
4 3 3 1 0 0 0 4 3 2 0 2 1 0 0 3 3 3 1 4 4 3 4 2 0 4 2 4 1 3 0 0 3 4 1 0 1 1 0 3
1 0 4 2 4 0 4 0 0 1 4 0 4 1 2 1 1 2 2 2 1 0 4 0 4 2 0 3 0 0 0 3 0 0 1 0 1 0 3 0
3 4 2 3 4 4 1 1 1 2 3 2 2 4 4 0 4 4 1 1 0 4 4 4 1 0 0 2 1 4 0 3 0 2 1 1 3 2 0 2
3 4 2 2 2 3 0 0 3 2 3 2 3 4 1 2 3 2 3 3 4 4 3 0 4 3 2 2 4 4 0 4 4 2 0 1 0 3 2 4
0 2 1 1 3 1 0 4 3 1 0 2 1 2 0 2 3 0 1 3 2 4 0 4 1 2 3 1 1 1 3 2 0 3 2 2 0 1 4 1
0 1 0 4 4 3 1 0 0 4 1 3 2 1 2 3 1 0 4 3 3 1 3 4 2 3 2 4 1 4 3 3 3 0 2 1 1 0 1 4
1 1 0 3 3 1 1 2 0 1 1 4 3 0 0 2 0 2 1 2 4 0 4 0 4 1 3 2 4 0 3 2 4 1 0 0 1 0 0 4
3 4 3 0 4 1 0 3 4 4 2 2 1 1 4 2 4 3 2 1 1 0 2 3 1 1 2 0 1 1 4 1 2 2 2 3 2 2 0 3
3 2 0 2 0 4 0 4 0 4 2 2 0 4 0 2 0 2 1 3 2 3 3 1 4 0 4 3 1 1 4 0 4 3 0 1 1 0 0 2
2 0 3 1 0 3 3 0 4 4 4 4 0 4 1 4 3 4 0 4 2 2 2 2 2 2 3 2 0 3 3 1 3 2 0 0 4 0 2 2
1 2 4 1 2 0 3 1 4 4 4 2 4 1 1 3 3 2 2 0 2 1 1 4 1 1 2 4 2 0 4 1 2 4 2 1 1 2 2 0
2 1 3 3 3 0 3 0 3 0 1 1 1 1 3 3 0 4 3 2 2 1 1 1 0 3 4 1 3 2 3 2 4 1 1 1 3 3 2 1
4 1 4 4 4 2 1 1 0 4 3 4 0 0 3 4 0 1 2 1 3 4 1 4 3 3 1 1 2 0 1 0 2 1 1 3 1 1 4 0
3 0 1 2 4 1 1 0 0 0 4 4 4 2 4 2 3 4 4 2 4 1 3 2 4 4 3 1 4 1 2 3 1 3 1 4 2 0 0 1
3 0 3 3 1 1 2 0 1 0 2 2 4 2 3 0 1 1 2 4 3 3 0 2 2 3 3 0 0 4 1 3 2 3 3 3 0 3 1 2
0 2 1 4 1 1 0 2 2 0 1 2 2 1 2 3 4 0 2 3 2 2 4 0 1 1 4 4 2 2 3 1 3 3 2 0 2 0 4 3
2 4 2 3 3 1 4 4 4 3 1 3 2 2 3 0 4 4 0 0 0 3 4 0 2 1 2 1 4 2 3 1 1 1 0 1 2 1 4 3
1 0 1 1 2 3 0 0 0 4 4 3 2 4 4 4 1 4 3 1 3 2 0 3 2 3 4 4 0 2 0 1 3 1 4 1 2 2 2 0
0 3 4 1 0 0 3 2 4 1 1 0 3 4 1 0 3 3 4 4 1 4 4 3 1 4 4 3 3 3 1 4 2 4 2 2 2 2 3 2
4 3 1 4 2 0 2 3 4 3 0 1 3 3 0 4 3 1 3 2 3 0 0 0 2 0 0 1 3 4 3 0 0 0 4 3 1 3 1 2
0 2 2 1 1 4 1 4 4 0 3 2 0 2 1 3 4 2 0 1 1 4 2 1 2 4 0 0 4 3 2 4 2 3 4 0 3 0 4 4
4 4 1 1 4 0 1 1 0 3 2 3 0 0 2 3 1 2 4 3 0 4 0 0 4 3 1 4 1 2 0 3 2 4 2 2 4 3 0 2
2 3 1 2 4 1 0 3 1 3 1 2 3 3 2 1 0 0 3 4 1 4 4 4 3 0 3 1 3 1 3 3 2 1 1 2 0 4 2 3
1 0 4 1 2 0 4 4 3 0 2 3 3 4 0 0 4 3 4 4 0 2 4 3 0 1 3 1 1 1 0 2 4 3 3 3 3 1 3 1
2 3 1 3 4 1 3 0 4 1 4 4 0 1 0 3 4 3 1 2 2 4 2 0 0 4 2 2 0 1 1 0 1 4 4 0 2 0 0 0
2 3 3 1 2 4 1 4 1 3 0 2 2 3 1 2 4 4 2 4 4 1 1 3 4 2 1 2 4 2 3 1 4 4 2 4 2 1 1 3
3 4 4 2 1 2 2 0 2 3 1 1 4 0 0 1 4 4 4 0 2 3 3 4 2 0 1 2 4 0 4 2 1 2 1 1 3 1 1 3
4 3 1 1 3 1 3 3 1 3 0 4 1 3 4 0 0 3 1 4 2 4 1 3 3 3 4 2 0 4 3 1 2 2 2 3 1 1 1 2
3 3 0 1 3 3 3 4 2 1 3 0 2 2 4 1 4 3 2 1 3 1 3 1 4 1 3 0 0 1 3 3 0 1 4 2 0 1 1 4
0 4 3 0 3 2 2 1 3 0 3 2 4 1 3 1 3 1 2 0 0 4 2 3 4 0 2 4 0 3 3 1 1 3 0 1 1 0 0 2
4 0 1 0 0 0 3 2 3 3 2 2 4 4 3 2 2 1 0 2 4 4 4 1 0 1 1 0 4 0 2 0 3 0 0 0 1 3 4 0
2 0 2 4 3 1 0 3 0 2 1 0 3 1 1 1 3 1 2 1 0 2 0 2 1 4 2 3 1 4 4 4 4 3 3 0 3 3 3 4
1 1 3 0 1 3 0 2 2 4 3 4 0 1 1 1 3 2 0 0 2 1 1 3 4 4 4 1 1 2 0 0 3 4 0 1 1 0 0 2

'layer players
64 60 64 64 64 64 61 62 61 63 64 60 60 60 61 64 64 63 63 64 62 60 64 63 63 61 64 60 64 60 60 63 60 61 60 64 63 63 64 62
60 64 63 60 64 64 63 61 63 61 61 64 61 60 60 61 61 62 64 64 63 63 62 61 64 61 60 64 64 61 64 64 62 61 64 60 60 60 61 63
63 63 60 62 64 63 60 63 60 61 63 62 64 60 64 62 61 62 60 61 63 62 64 64 63 64 62 61 64 64 61 62 62 64 62 60 62 60 63 64
60 64 61 62 62 61 62 64 63 61 64 61 62 62 63 60 61 62 60 61 61 63 64 62 62 61 60 64 61 61 64 60 64 60 62 62 63 62 63 61
60 62 63 64 60 64 60 60 63 62 61 62 60 60 60 62 60 61 64 64 61 64 60 61 64 64 63 62 60 61 61 62 64 62 64 63 62 60 64 60
63 63 61 62 61 61 64 64 62 60 60 62 60 62 64 64 62 63 64 60 64 64 60 62 63 62 63 63 62 64 60 64 63 61 61 64 62 60 62 62
64 61 60 64 64 60 61 63 63 61 60 63 64 64 62 64 62 62 61 61 60 61 63 60 61 63 62 62 63 64 60 63 62 63 63 62 60 63 60 64
61 60 63 61 60 60 63 63 60 64 62 61 60 61 63 61 63 63 64 61 60 62 63 64 61 61 62 64 60 60 60 60 62 61 62 62 63 61 60 63
64 62 62 60 62 61 60 62 62 63 60 64 64 60 61 63 63 61 61 60 64 62 61 62 63 64 64 61 60 60 62 63 60 63 60 64 62 64 60 62
63 61 64 63 64 63 63 62 60 60 62 60 62 63 62 63 60 63 60 63 60 60 61 63 62 61 61 61 62 64 60 61 61 63 60 62 60 60 61 62
62 63 62 60 62 61 64 64 60 60 62 60 62 60 62 64 63 63 61 62 62 61 63 60 64 62 63 60 61 61 60 64 62 63 63 62 61 63 60 62
60 64 62 64 63 60 60 60 61 63 62 62 64 60 61 60 64 63 64 64 60 63 64 63 61 62 61 61 63 63 62 60 64 63 64 64 63 63 61 60
61 61 63 64 61 63 60 64 64 61 62 63 60 61 64 64 64 64 60 64 60 61 60 62 61 64 61 62 64 61 62 61 63 64 61 62 63 64 64 64
60 64 61 61 62 64 60 61 63 64 61 60 64 64 64 60 63 60 62 61 61 64 62 62 62 63 61 62 60 61 60 64 63 63 60 63 62 63 63 60
60 64 63 61 60 64 62 63 64 63 61 64 60 62 63 63 60 63 64 60 64 63 60 60 62 63 63 60 60 60 62 61 63 64 61 64 64 62 62 62
61 64 63 60 61 61 62 60 60 60 64 60 63 60 60 64 60 62 63 64 62 61 62 62 61 63 61 60 64 61 63 60 62 64 61 60 62 64 62 63
64 63 61 62 64 64 61 64 64 64 63 60 64 60 63 62 61 60 64 62 64 61 62 62 60 62 60 64 64 63 63 61 63 62 62 61 62 64 64 60
61 60 63 60 63 63 60 61 63 63 64 64 62 64 64 61 64 64 63 62 60 64 60 62 63 60 61 63 64 63 62 60 62 61 63 60 60 61 62 60
63 62 62 62 64 63 61 64 61 64 60 62 64 64 63 60 64 62 63 64 64 62 60 61 60 63 63 60 64 60 63 61 61 60 60 64 63 63 64 61
64 62 61 61 61 62 60 60 62 61 60 63 61 61 61 62 61 60 64 61 63 62 62 63 63 61 61 62 61 62 61 60 64 60 60 64 62 64 60 63
60 64 61 62 63 64 61 61 60 63 63 63 61 60 60 60 62 60 60 64 63 63 62 61 62 60 62 61 60 63 63 63 64 63 61 62 64 61 63 63
63 63 61 62 61 64 64 64 62 62 64 60 60 61 60 63 61 62 61 64 61 60 64 61 60 63 60 63 63 60 64 60 63 63 64 64 64 60 64 61
63 61 62 63 61 64 64 63 61 61 64 60 64 60 60 60 61 61 62 61 60 61 64 64 61 60 62 61 63 61 64 64 61 63 61 63 62 61 63 62
64 60 62 61 62 63 61 60 64 63 60 62 60 60 62 64 63 61 62 63 64 63 62 61 62 61 60 63 60 64 64 63 62 63 64 64 62 60 63 61
61 64 60 62 63 63 60 62 62 61 60 64 63 63 63 60 62 63 64 62 63 60 63 63 61 64 64 64 61 60 63 64 64 60 61 60 61 61 62 62
62 62 62 64 61 60 60 60 60 60 62 64 62 60 64 63 64 62 63 62 63 64 62 60 64 61 64 63 61 64 62 61 63 63 61 63 62 64 62 60
62 61 61 61 62 63 63 62 60 63 61 62 63 64 63 61 62 62 62 64 60 62 61 62 64 60 61 61 64 64 60 62 64 62 63 60 64 60 60 64
61 60 60 62 63 61 61 63 62 61 60 64 61 62 63 61 62 60 60 63 64 60 60 61 64 61 64 63 62 64 62 60 61 62 62 61 64 63 62 62
63 61 60 63 60 60 61 62 60 60 62 60 64 60 60 63 62 64 63 62 64 64 61 60 60 62 61 64 63 61 63 60 62 64 64 62 64 63 63 60
61 62 61 61 63 64 62 62 61 63 61 63 62 60 61 64 60 60 63 61 63 61 60 64 60 61 62 63 64 62 63 63 64 61 61 64 60 61 60 64
60 63 63 60 60 60 61 64 62 60 64 60 61 62 60 62 64 61 61 63 62 64 64 63 62 63 63 62 64 63 60 60 63 60 60 60 63 60 64 63
60 63 63 64 62 60 63 60 60 61 63 63 60 63 64 60 61 60 63 63 62 61 60 61 63 64 62 64 63 62 63 64 62 64 60 63 61 60 61 63
62 61 60 61 62 63 63 62 64 62 63 63 60 61 63 64 63 62 62 62 63 63 62 64 64 63 63 61 64 64 63 64 61 64 64 62 62 64 62 62
62 64 62 60 60 60 62 64 60 62 61 62 64 64 60 63 64 60 64 60 60 64 64 62 60 63 62 63 64 63 63 63 60 60 63 60 63 63 64 60
61 60 61 64 61 61 64 60 61 62 63 64 63 64 62 60 61 64 64 64 62 63 60 63 62 60 64 64 62 60 63 60 60 61 61 64 61 60 61 64
61 61 61 62 62 61 63 61 61 60 64 64 60 64 63 64 62 62 61 62 62 61 61 63 63 63 60 62 61 63 62 60 64 64 63 62 64 62 62 61
61 61 61 62 62 64 61 62 63 60 62 64 64 60 63 63 61 63 62 60 64 62 63 61 60 61 61 64 61 63 60 60 63 64 60 64 60 63 62 64
62 62 63 62 64 63 62 64 61 64 64 63 61 62 61 60 62 60 64 60 62 63 64 60 61 63 64 63 63 61 60 64 63 64 64 60 64 61 63 61
62 62 62 61 60 60 61 60 63 62 62 64 60 61 63 63 63 62 61 60 64 61 60 62 64 61 60 60 63 60 62 62 62 64 61 64 62 60 61 64
63 63 61 64 62 63 60 61 60 63 64 63 60 64 62 63 61 62 63 60 63 63 63 62 61 63 63 64 62 61 63 61 63 62 60 62 64 61 62 63

'layer roofs
31 34 32 30 30 34 33 33 30 32 32 30 34 31 33 32 32 32 33 30 31 30 30 31 34 33 33 32 33 34 34 31 30 31 32 33 30 32 32 33
33 30 30 31 34 31 33 31 31 34 30 34 34 30 32 32 32 31 32 30 30 33 34 32 30 31 34 30 30 32 34 30 32 34 32 31 34 33 34 31
32 33 32 33 30 34 32 33 31 34 33 33 34 33 30 34 31 34 33 33 32 31 32 32 34 31 32 31 31 30 30 31 32 33 32 32 30 34 31 32
32 34 33 31 32 32 33 30 30 33 31 31 32 30 33 31 33 31 33 31 34 34 34 33 33 31 34 34 33 33 31 33 33 34 30 30 31 34 32 34
30 31 34 30 32 34 34 32 33 34 33 33 30 32 34 30 34 34 34 33 32 34 34 34 31 32 31 34 34 34 34 30 30 33 34 30 33 32 30 32
30 31 33 30 32 32 32 33 31 31 32 33 30 33 32 31 31 32 30 33 31 34 34 31 31 34 34 32 32 34 33 32 31 30 32 30 33 30 32 30
32 34 30 34 31 33 33 30 34 32 34 31 34 34 31 33 30 31 33 34 31 30 31 32 31 31 34 30 32 32 31 32 32 34 33 30 30 32 34 34
32 34 32 32 30 31 31 32 31 30 33 34 32 34 34 33 33 31 34 32 32 31 31 33 33 31 31 32 30 33 30 33 31 31 31 32 32 32 30 33
32 31 34 34 31 30 30 30 32 30 31 30 34 31 30 32 34 32 30 30 33 33 32 30 33 31 32 32 34 31 34 33 31 34 31 30 33 34 32 30
33 31 33 34 30 34 33 34 30 31 30 30 32 30 31 33 31 32 34 31 32 30 33 31 30 34 31 34 30 30 33 32 33 34 30 33 31 34 33 32
31 34 34 32 32 31 31 34 33 30 33 34 32 34 32 32 32 34 33 32 34 33 32 32 34 33 33 32 33 31 34 34 31 33 33 30 34 31 31 33
34 33 31 30 34 32 30 34 30 32 34 34 32 34 34 31 30 30 30 34 34 32 34 34 33 33 31 32 33 34 33 33 31 30 32 31 34 32 30 30
33 33 34 32 32 33 33 32 30 34 34 30 32 32 30 31 32 31 32 33 32 31 31 30 32 34 34 30 30 30 34 30 34 30 33 32 32 31 33 34
32 34 32 33 31 32 31 32 31 32 32 34 32 31 34 33 31 34 33 33 34 34 30 32 31 32 32 34 34 30 34 32 33 32 32 30 33 32 31 33
32 30 31 30 32 30 34 33 34 31 31 31 32 33 31 32 34 33 30 32 30 30 31 33 31 30 32 34 34 30 33 33 33 33 31 33 31 33 34 30
31 30 34 31 30 32 34 31 34 30 30 32 33 31 31 34 34 31 34 32 30 32 30 30 30 34 31 34 33 30 32 33 34 30 30 31 31 31 34 32
34 32 30 31 33 32 33 31 30 32 30 30 32 33 31 32 30 34 32 32 30 30 33 32 31 30 32 32 31 33 30 31 32 30 34 34 30 31 32 34
32 32 30 34 31 33 31 34 30 31 34 33 34 32 34 34 34 34 31 30 34 34 34 34 31 34 34 30 32 34 32 32 31 34 34 31 32 31 33 34
33 33 31 33 31 30 30 30 31 32 30 31 32 32 33 31 30 33 33 33 34 30 31 30 30 33 30 32 30 32 34 34 30 32 32 34 32 31 33 31
33 34 32 30 33 30 31 32 30 32 33 30 33 34 32 32 31 30 34 33 30 32 33 31 34 31 34 30 33 32 30 31 30 30 31 30 33 32 33 31
33 34 32 31 34 32 30 30 31 33 33 32 34 32 33 34 34 33 31 34 33 33 32 31 32 31 30 34 32 34 33 33 34 30 31 32 33 34 31 31
32 30 32 33 33 31 33 33 30 33 31 32 32 30 31 33 30 30 31 30 31 33 34 34 31 33 34 33 31 33 34 32 33 30 32 33 34 31 33 31
32 34 31 34 33 32 31 33 32 32 30 32 34 30 30 32 30 30 31 33 31 32 31 30 30 34 30 30 34 34 32 34 31 30 30 34 30 31 34 33
33 30 32 34 32 30 31 30 32 33 31 31 33 33 33 30 33 30 33 34 32 32 32 32 31 33 30 32 30 34 32 30 30 32 34 30 31 30 30 30
31 32 33 34 34 31 34 32 34 30 32 34 34 30 32 34 33 34 32 30 30 30 34 33 30 33 30 32 33 31 33 31 32 33 30 31 32 33 31 30
32 30 34 30 30 34 34 32 34 31 34 33 31 30 33 34 33 31 33 32 31 34 34 33 33 31 32 31 33 34 30 34 32 32 34 32 32 31 30 34
32 33 33 32 34 32 34 32 32 32 33 34 32 30 32 30 31 31 31 33 32 33 30 30 31 32 31 31 31 33 32 30 32 32 34 33 33 34 34 30
32 31 32 32 30 32 34 31 32 30 31 32 30 32 30 30 32 31 34 34 30 34 33 31 34 31 32 33 33 30 32 30 33 34 34 32 30 30 31 31
30 34 33 32 34 33 30 32 31 32 34 33 30 30 32 33 34 30 30 31 32 30 32 32 33 34 30 33 31 33 30 30 32 32 31 34 33 32 33 34
32 31 31 32 34 34 34 30 33 32 32 31 33 34 31 32 34 34 32 34 31 32 31 34 31 33 30 34 33 30 33 32 32 31 30 30 34 31 30 32
34 32 34 34 33 30 33 32 30 31 33 34 32 33 30 30 33 32 32 30 33 31 31 33 30 34 34 33 30 34 31 32 34 30 34 34 30 34 32 33
31 30 30 31 33 31 31 34 33 33 30 32 33 34 32 33 31 32 34 32 33 34 30 34 33 31 33 32 34 30 32 32 32 34 31 33 30 30 31 31
30 30 32 34 31 32 31 33 33 30 32 32 34 31 33 34 33 30 30 33 34 31 34 30 30 31 33 32 34 31 33 33 34 31 31 33 32 30 33 30
34 33 34 32 33 31 31 32 34 30 33 30 32 32 33 32 30 33 30 32 33 32 34 32 34 34 30 31 33 34 30 33 31 33 33 32 34 31 33 34
34 33 33 33 30 34 31 33 32 34 30 34 34 34 34 33 32 31 30 31 31 34 31 31 34 34 32 32 34 31 32 33 33 31 31 32 33 33 32 32
30 31 30 34 30 31 34 31 34 30 32 30 32 32 34 34 34 32 32 31 31 32 31 30 33 34 33 31 31 32 33 33 30 33 30 32 33 31 34 31
31 32 32 30 30 34 30 34 32 33 32 32 33 30 32 34 34 33 34 33 32 33 32 31 30 31 33 33 31 30 30 34 33 34 31 34 30 30 30 34
31 32 30 34 30 34 32 30 34 32 32 30 32 30 33 34 33 33 31 30 30 31 33 33 31 34 30 34 34 34 34 30 30 34 34 34 33 33 34 30
34 31 31 33 32 32 34 34 34 33 32 33 33 30 33 33 31 31 33 34 33 31 32 32 32 34 34 30 32 32 31 31 32 32 31 30 31 33 30 33
30 32 30 33 34 32 31 33 34 30 33 34 30 30 33 32 33 31 34 31 33 34 33 34 32 30 34 34 32 30 33 31 31 32 33 31 30 31 30 30

'layer plants
22 20 20 24 21 23 23 20 20 23 20 21 21 22 22 23 21 24 22 24 20 22 22 22 23 21 21 23 22 21 23 21 24 21 23 23 24 22 20 22
23 24 20 22 20 20 22 24 20 20 20 22 22 20 23 20 20 21 22 23 21 23 21 24 22 20 20 21 21 24 23 24 23 23 20 24 21 21 21 21
21 22 24 24 20 22 22 20 21 23 20 22 24 21 24 23 24 22 20 22 21 24 20 23 23 20 24 21 20 23 21 23 23 24 21 20 22 22 20 22
24 22 21 24 24 21 21 21 23 24 20 22 23 21 22 23 23 21 21 20 20 20 20 24 23 24 23 22 20 20 24 23 23 20 20 24 20 22 23 22
22 21 20 22 22 24 21 23 22 22 24 23 24 23 23 23 24 24 22 20 21 21 23 23 21 24 22 24 24 23 21 23 20 21 22 22 22 24 24 20
20 21 20 22 23 20 20 21 21 21 20 20 21 20 21 21 23 24 20 23 20 22 20 24 23 20 23 22 21 20 21 21 23 20 24 20 22 20 20 21
22 21 21 23 24 24 24 22 24 22 22 21 22 21 20 20 20 22 23 21 24 22 23 23 24 20 20 24 21 20 24 21 22 23 23 20 23 22 22 24
24 21 23 24 22 22 21 20 20 20 22 24 23 21 23 23 23 24 21 20 20 20 22 23 24 24 23 20 24 23 24 24 20 23 21 24 23 23 20 23
22 24 21 23 22 24 22 22 20 23 21 22 21 22 22 22 21 20 20 21 20 22 23 24 21 22 20 23 24 20 22 22 20 23 22 22 21 24 24 20
24 21 22 22 22 20 23 21 22 24 24 21 24 22 24 22 22 20 21 20 20 24 22 23 20 21 22 20 21 20 23 22 20 24 23 24 22 23 23 23
20 22 23 23 22 23 21 24 23 24 23 22 20 24 20 22 22 24 24 24 20 21 23 23 24 24 21 22 20 20 22 20 22 20 24 22 21 21 20 22
21 21 24 22 22 23 20 23 23 20 23 22 23 24 23 22 23 22 21 24 20 23 23 21 21 23 24 20 21 23 23 21 23 24 22 21 24 20 21 20
21 21 24 21 24 23 23 20 24 20 23 23 22 24 23 23 20 22 20 20 24 24 20 23 21 22 20 21 24 22 21 20 22 23 21 24 22 23 24 24
24 24 21 21 20 21 20 24 24 23 23 23 20 22 23 24 24 20 20 23 21 24 20 22 22 22 22 21 21 20 21 24 21 21 24 21 23 21 21 22
24 20 24 22 22 20 23 24 20 22 24 20 23 21 24 24 20 23 20 22 24 23 22 22 24 22 20 23 24 24 24 23 21 21 24 23 22 24 22 23
22 24 21 22 22 21 20 20 23 20 24 24 23 21 21 20 21 24 24 23 22 20 21 20 24 20 21 21 20 21 23 21 20 21 24 24 23 21 22 24
23 20 20 23 22 23 20 21 22 23 20 24 22 20 23 21 21 23 22 24 22 21 20 23 20 21 23 20 20 24 24 23 22 21 20 22 20 20 23 23
21 23 24 23 24 20 23 20 20 20 22 23 20 23 22 23 24 22 21 22 22 21 23 20 20 20 21 23 24 21 20 22 24 21 22 24 22 23 23 24
23 21 23 23 24 20 20 23 24 23 23 24 23 20 20 20 23 23 21 20 21 24 21 20 23 24 23 22 22 20 20 20 20 23 24 24 20 20 20 20
23 21 24 24 22 20 22 24 23 24 23 24 21 20 22 21 23 21 21 23 20 24 21 20 24 21 21 24 23 22 20 22 23 22 24 22 24 22 23 20
22 24 24 22 24 21 20 24 23 20 22 20 23 21 22 23 22 21 24 23 21 23 23 20 23 21 20 22 22 24 23 23 20 21 22 21 22 21 21 22
24 24 21 21 20 23 22 22 22 23 23 23 22 22 23 22 23 22 21 21 22 23 20 20 20 21 22 21 22 22 22 22 23 20 24 20 24 20 22 24
20 22 24 23 23 24 23 20 20 22 21 20 22 21 24 22 20 22 22 24 23 22 20 21 23 20 23 24 22 24 21 22 20 22 22 23 20 22 24 21
20 21 20 22 22 22 21 21 21 20 20 21 23 23 21 23 20 20 23 23 24 22 22 21 24 23 20 24 24 20 23 22 24 20 23 23 23 24 22 20
20 24 20 24 24 24 21 24 24 21 21 21 22 20 23 23 21 21 21 21 21 20 24 24 20 23 24 21 20 21 22 23 20 21 22 22 22 20 22 23
21 21 21 23 20 20 24 21 22 21 20 21 24 21 24 20 21 21 21 22 21 22 24 21 21 20 23 21 23 24 20 24 20 24 21 23 21 23 20 20
24 22 24 23 23 22 21 21 24 23 20 22 23 22 20 24 23 23 22 23 21 24 23 21 23 24 24 22 24 21 24 20 21 23 24 24 22 20 21 22
23 22 20 21 24 20 22 21 22 20 22 23 22 20 23 20 21 20 24 20 22 24 22 22 22 20 22 22 20 23 21 23 20 22 23 21 23 21 20 22
21 22 20 24 24 20 23 22 24 21 23 21 20 20 21 23 20 24 22 21 24 23 24 23 22 24 20 22 24 23 23 21 20 20 21 23 22 23 23 24
20 21 22 22 22 21 21 21 23 22 24 21 21 21 21 22 21 22 20 23 23 23 21 21 20 20 20 24 24 20 20 23 24 23 20 24 20 20 21 22
24 21 20 23 20 24 21 22 23 23 20 21 23 22 21 23 24 20 24 22 20 20 24 22 21 20 20 20 23 24 20 23 24 24 23 22 20 24 21 23
22 23 22 20 24 24 23 24 22 22 23 20 21 21 23 23 20 22 22 23 20 21 22 23 21 21 24 21 21 22 24 24 22 21 21 22 21 24 20 20
21 24 23 23 24 21 24 20 20 22 24 23 22 24 24 21 21 24 24 24 24 22 21 23 23 22 23 24 23 21 24 21 24 21 23 22 20 24 20 20
20 22 23 20 24 24 20 21 22 20 24 22 22 21 20 22 23 20 21 21 24 24 24 23 23 20 22 20 21 24 23 24 24 24 20 21 24 20 21 20
22 21 20 24 22 24 20 22 20 20 21 22 21 21 24 22 22 20 23 21 23 20 24 21 24 24 24 23 22 22 24 24 23 20 23 24 21 20 21 22
20 20 23 23 22 20 24 23 22 24 22 24 23 20 24 21 23 20 20 23 22 24 23 23 20 24 24 20 23 22 22 21 23 22 21 24 24 24 20 23
20 22 24 22 20 23 23 21 20 20 20 20 21 24 23 23 22 23 24 21 22 24 22 23 24 23 24 22 22 24 21 20 21 21 24 21 22 21 24 24
24 23 21 24 23 20 20 23 23 20 24 20 24 23 22 21 20 23 23 20 24 20 23 21 21 23 21 23 22 24 24 21 21 23 20 22 21 21 22 24
20 23 20 23 20 22 20 20 22 20 21 24 21 23 21 24 23 21 21 22 22 22 22 20 24 22 22 24 21 23 22 20 20 21 23 22 20 22 20 21
24 21 22 23 21 20 20 22 22 21 21 22 23 22 24 23 21 20 22 21 23 21 21 24 21 24 22 20 21 22 24 23 23 22 23 21 23 22 22 20

