'meta w 40 h 40 "first_map"

'layer animals
33 34 34 32 32 30 31 31 32 34 33 34 32 33 33 31 30 30 31 33 32 32 32 34 33 32 31 33 32 33 32 33 31 31 34 32 31 33 31 34
33 33 33 31 32 31 31 33 34 33 30 33 33 30 34 33 30 34 31 33 30 32 31 30 31 30 30 34 30 33 32 31 31 33 30 30 34 34 31 30
33 32 32 34 33 32 32 30 33 34 34 33 32 33 34 34 32 30 32 33 34 33 32 33 31 30 31 32 31 34 31 31 34 31 31 32 32 31 31 30
32 30 34 31 32 34 32 32 30 30 30 34 33 34 30 30 33 32 33 34 34 34 31 32 34 32 33 31 30 33 30 31 33 31 32 33 32 30 31 30
31 34 33 33 34 33 30 33 30 30 31 33 31 34 31 31 34 31 31 30 33 31 30 34 30 31 34 33 34 33 32 31 31 34 30 31 33 30 34 32
32 34 33 30 34 32 33 31 30 30 32 33 32 30 34 30 32 34 34 30 30 30 32 34 33 34 33 31 34 30 34 30 32 30 32 32 30 31 34 30
33 34 30 31 32 33 32 34 32 32 30 31 33 33 33 32 32 32 32 33 30 30 30 32 30 34 34 31 33 34 30 32 33 32 31 32 32 31 33 32
32 33 34 31 34 34 32 31 33 32 31 34 34 33 34 32 31 33 31 32 33 30 33 30 32 34 31 32 34 31 30 31 34 30 32 31 34 30 34 32
34 31 33 34 31 30 30 33 30 30 31 30 30 32 34 32 30 30 34 31 31 33 33 34 32 32 33 34 32 33 30 34 30 31 33 31 31 32 31 34
33 33 34 34 33 32 34 30 34 34 34 30 34 31 30 33 30 33 31 32 30 31 31 32 33 34 32 31 31 34 32 32 34 33 34 32 30 30 31 30
32 33 31 31 34 34 32 31 30 32 31 31 33 31 31 30 31 30 33 32 34 32 31 32 31 33 34 32 32 34 32 32 33 32 31 34 34 30 31 33
33 33 32 32 30 30 32 30 33 31 34 31 33 30 31 32 32 33 33 33 30 30 34 32 30 30 32 33 30 33 31 30 30 34 31 33 34 34 31 30
31 30 34 31 33 34 33 33 33 34 31 33 32 31 31 31 31 31 34 32 31 32 30 30 34 30 30 30 33 30 32 34 32 32 34 33 31 34 34 30
31 31 31 33 34 31 33 34 33 30 31 31 30 34 33 31 32 33 32 33 32 30 33 32 34 30 31 31 33 30 30 32 31 33 32 34 32 30 32 30
32 34 33 30 33 34 31 33 31 32 30 32 32 34 33 30 34 30 31 30 33 34 33 34 33 30 34 32 34 31 34 32 30 31 33 33 30 33 32 30
33 33 31 33 33 34 33 31 31 31 31 34 33 33 30 32 30 33 31 30 33 34 32 34 30 32 33 32 30 30 30 34 30 32 31 31 34 30 33 31
33 33 34 33 33 30 34 30 30 33 30 31 31 31 34 33 31 34 32 33 34 32 31 34 32 32 32 34 30 31 33 33 32 30 31 34 31 32 32 30
34 31 33 30 32 34 32 34 34 30 31 34 34 30 31 31 30 32 34 30 31 34 32 31 34 30 31 32 32 32 31 32 33 32 31 34 31 33 33 33
33 31 30 33 31 30 32 33 31 34 33 33 34 31 33 30 31 30 32 30 33 30 32 32 31 33 32 30 31 31 33 32 32 32 33 33 34 32 30 34
30 30 34 33 32 32 33 33 34 30 31 31 32 30 31 31 33 34 32 31 34 30 32 32 32 33 30 34 34 33 30 32 33 32 32 31 33 31 34 32
31 34 30 32 33 32 34 31 33 32 30 30 30 31 31 32 32 34 31 32 34 30 32 32 32 32 33 32 33 31 33 34 31 31 32 32 31 32 32 30
33 34 30 31 30 34 30 33 34 33 31 32 31 31 32 34 32 30 31 30 30 34 33 31 31 30 30 32 30 34 31 34 30 34 30 34 33 32 30 30
30 33 30 34 31 33 30 31 32 34 33 31 32 33 31 33 33 33 32 31 32 30 31 34 30 32 30 34 30 31 31 32 32 32 33 34 34 34 34 32
32 34 32 32 31 31 32 30 30 33 31 30 34 33 30 32 32 33 33 32 31 34 30 31 31 31 30 33 32 30 32 34 31 31 33 32 31 31 34 33
30 31 31 33 31 34 30 34 34 30 32 33 32 32 32 31 33 31 31 30 32 34 34 32 31 30 33 34 33 33 31 30 30 31 32 30 34 32 30 33
31 34 33 31 31 32 30 32 32 32 33 33 32 31 31 31 34 34 33 32 32 33 32 33 31 31 30 31 34 31 34 32 31 32 32 32 34 33 32 30
33 34 33 34 33 30 32 33 34 34 33 34 31 34 33 30 32 32 30 32 33 34 30 30 32 31 33 31 31 34 32 34 33 32 32 33 33 31 34 31
31 32 33 30 34 31 31 34 33 30 34 34 31 31 31 34 31 34 30 31 32 32 34 34 33 31 34 31 31 31 31 32 32 31 33 31 30 32 30 30
33 32 32 30 31 31 33 33 30 30 31 34 34 30 34 31 30 32 34 30 31 34 31 34 30 30 30 32 31 33 34 34 31 32 33 34 32 31 32 30
32 31 30 30 30 31 31 33 33 34 31 30 30 32 31 34 31 30 33 34 33 32 30 30 34 34 33 31 34 30 33 34 31 34 31 31 31 34 34 30
34 30 30 33 34 34 34 34 32 32 32 34 34 31 33 34 33 34 33 32 30 32 30 30 31 34 33 31 31 31 30 31 31 34 33 32 34 33 30 33
31 33 30 31 33 32 31 34 34 33 32 32 30 32 31 31 34 33 32 31 33 33 34 32 33 34 33 33 34 31 30 33 32 30 32 31 30 32 31 32
32 30 34 30 32 32 33 30 34 30 32 33 31 30 31 30 34 30 31 34 31 30 33 33 30 33 31 32 33 31 30 30 34 34 34 32 31 30 33 33
33 33 30 34 34 30 32 32 30 32 33 30 30 31 30 34 33 32 34 34 33 31 33 34 33 31 33 34 30 30 34 31 34 31 34 34 31 30 31 32
30 30 33 32 32 34 34 30 31 30 32 32 33 32 34 31 31 32 34 32 34 32 31 31 33 31 33 33 31 34 33 32 31 32 32 30 33 30 30 30
33 31 31 32 30 32 32 32 34 34 33 33 31 34 32 30 31 31 33 33 30 32 31 32 32 34 30 30 33 30 31 34 34 34 33 30 33 33 32 31
33 34 33 34 31 31 33 34 31 34 31 32 30 31 33 33 34 30 33 31 32 34 31 31 33 30 33 33 33 32 31 33 31 30 31 31 34 33 33 30
33 31 30 31 33 34 32 31 34 33 30 31 31 31 31 32 30 33 33 30 32 30 33 30 34 33 31 34 30 32 34 32 30 30 34 32 30 32 32 30
31 30 30 33 34 32 30 31 32 30 32 32 34 30 31 34 32 32 30 33 31 30 33 31 31 34 30 31 33 33 34 34 34 30 30 33 33 33 33 34
32 34 34 32 31 32 34 33 30 30 32 30 32 34 32 30 30 30 33 34 30 30 33 32 30 32 30 33 30 32 33 32 30 32 31 30 32 34 34 30

'layer ground1
1 4 4 5 2 2 5 3 0 1 3 3 2 2 3 1 3 5 4 3 2 5 5 0 4 2 0 4 4 0 4 2 5 0 3 0 3 3 3 3
4 7 14 5 13 5 1 3 1 0 0 4 0 4 1 0 1 3 2 5 3 5 5 1 3 5 3 0 2 0 3 2 1 3 2 5 5 1 5 1 5 0 5
0 8 15 0 12 0 1 2 2 3 5 5 5 1 4 5 2 5 2 4 3 2 4 1 2 2 2 0 0 1 2 1 3 2 0 5 1 5 3 2 2 1 0
4 9 10 11 4 0 3 0 1 5 4 2 5 0 5 3 0 3 2 0 5 0 5 4 0 4 1 4 0 4 0 5 0 2 3 1 1 2 1 2 1 1 0
3 3 5 5 1 1 3 2 0 1 5 5 4 2 0 1 2 1 0 0 1 1 4 4 3 4 5 0 3 5 4 3 2 2 5 2 2 1 4 1
0 2 0 3 3 4 5 3 2 2 4 4 3 3 1 5 3 0 5 2 1 1 2 4 1 5 4 1 3 2 4 5 2 5 5 4 1 5 0 1
2 3 4 3 1 5 2 5 5 3 0 5 5 0 3 2 5 0 0 1 4 4 4 4 4 3 3 4 4 1 1 1 5 1 2 3 3 4 5 4
2 4 3 0 3 3 0 1 5 0 1 2 4 1 0 0 5 3 5 1 0 4 0 4 1 1 3 3 2 3 2 3 1 2 1 3 4 4 3 3
4 0 4 5 0 0 4 0 3 2 1 2 5 2 1 3 4 1 2 3 1 0 5 1 5 1 4 5 2 3 2 3 2 0 1 3 2 4 0 5
4 3 1 3 2 3 5 3 5 5 0 3 3 2 5 0 3 5 4 1 0 0 0 5 5 2 2 4 0 4 4 1 1 3 4 3 5 3 5 2
0 1 0 5 5 0 1 5 2 1 2 4 3 4 4 5 3 4 4 2 0 2 0 5 2 1 4 0 0 0 2 1 1 4 3 4 2 2 1 3
4 4 5 3 1 5 3 2 2 1 3 0 4 3 4 4 0 3 5 0 5 3 1 1 3 5 0 2 5 5 0 2 2 4 5 4 5 5 2 2
0 5 2 4 0 2 3 3 3 1 5 3 4 2 3 1 2 1 5 1 0 3 0 1 1 2 0 1 3 2 4 1 2 1 1 4 1 0 1 2
0 1 4 0 0 5 4 0 1 2 4 4 2 0 0 1 0 3 4 5 0 4 3 1 4 5 5 2 5 0 1 2 1 2 1 1 4 5 0 2
1 5 5 2 1 3 4 1 0 4 0 5 1 2 4 2 3 0 1 2 2 4 0 2 1 0 2 3 3 0 0 3 2 2 3 4 1 5 3 3
0 0 0 2 4 0 1 5 4 4 5 2 0 0 3 3 1 2 1 3 5 5 4 4 5 2 3 0 5 1 4 4 2 2 0 3 3 0 4 3
2 4 1 2 2 0 0 4 4 5 0 1 1 1 5 0 3 4 5 0 2 5 0 4 0 3 4 0 3 4 1 1 0 2 4 2 1 5 5 2
5 0 1 4 4 5 3 1 3 2 0 2 3 1 0 0 3 3 1 1 2 2 5 5 4 2 5 4 5 1 1 4 2 3 3 5 2 1 5 4
4 0 5 5 0 2 0 5 4 4 4 1 3 2 4 3 2 4 5 2 0 0 2 3 4 2 5 3 0 2 1 3 1 1 3 3 2 4 1 4
2 5 2 5 5 5 2 4 2 0 0 1 3 1 5 1 0 4 3 4 1 1 2 0 2 2 3 0 1 0 0 5 3 0 5 2 3 5 3 2
0 0 5 5 3 4 3 0 1 0 4 3 5 1 4 5 0 5 1 3 3 3 2 2 3 3 3 5 4 4 3 1 1 2 1 3 4 5 5 4
1 3 3 0 3 2 5 0 0 0 1 0 1 5 0 1 2 4 0 3 5 3 2 3 3 1 0 5 3 4 3 2 3 0 3 2 2 0 3 3
0 5 1 1 3 3 3 5 0 5 0 2 5 4 1 2 5 3 2 4 0 0 0 1 1 5 0 1 4 1 0 3 1 1 1 1 1 0 1 1
1 0 1 4 0 0 4 0 2 4 0 3 1 4 4 3 1 2 1 5 1 5 0 4 2 0 4 4 5 4 1 5 1 1 2 1 2 5 3 3
5 2 1 5 3 4 5 4 3 3 4 1 2 2 1 1 5 4 0 4 5 1 5 0 2 4 1 1 0 2 0 0 4 4 5 4 0 1 2 3
5 5 3 0 0 0 5 4 1 1 3 4 3 0 3 2 2 4 1 4 0 1 3 1 2 1 5 3 1 3 1 4 2 3 3 2 0 3 0 0
4 0 4 5 0 5 4 1 3 3 0 4 5 2 0 2 5 4 5 2 3 4 5 1 3 1 0 4 1 4 0 2 0 2 1 4 2 2 0 4
1 0 2 2 0 3 2 4 3 5 3 3 1 3 5 4 2 4 0 1 4 3 1 3 1 5 2 3 5 2 3 1 0 0 0 4 2 3 2 1
0 2 2 2 4 5 4 5 4 0 3 3 4 3 2 4 2 5 0 2 2 0 4 0 1 0 2 0 2 0 4 4 0 2 3 5 4 5 5 3
3 2 0 0 1 0 2 0 4 2 3 5 1 3 4 1 1 3 1 4 0 0 1 3 2 0 1 4 4 5 2 2 1 1 3 4 1 1 1 1
2 3 1 3 0 3 1 3 4 0 3 3 5 0 4 1 1 0 3 3 0 4 3 0 3 5 5 0 1 4 5 0 2 0 1 4 4 0 4 3
4 2 2 4 4 4 5 0 5 2 3 4 2 4 5 3 5 2 1 4 0 2 5 5 2 5 1 2 2 2 3 3 0 2 3 3 1 1 0 4
2 3 4 0 1 1 5 3 2 4 1 0 2 5 5 5 4 2 5 5 5 4 3 1 0 5 2 4 2 4 4 1 4 2 2 0 5 3 4 4
5 5 0 3 4 2 2 3 2 3 0 3 1 3 0 3 2 5 2 3 1 4 4 5 4 5 2 3 4 3 0 2 5 2 2 4 1 1 3 3
3 5 4 3 4 1 0 3 1 0 2 1 3 2 0 2 0 0 3 0 3 3 2 5 2 1 2 2 3 0 5 3 5 3 5 0 2 0 5 5
2 1 0 5 1 2 1 5 0 4 5 1 3 0 4 2 4 3 2 5 3 0 3 0 4 0 3 4 0 5 4 4 4 5 4 2 5 0 4 0
2 4 5 1 4 2 2 0 3 2 5 2 3 1 4 0 4 1 2 5 2 2 2 3 2 2 3 1 2 2 1 3 0 4 3 0 2 4 5 1
3 1 0 2 2 1 3 1 5 1 1 4 3 1 5 3 0 4 4 5 2 1 0 4 3 1 3 4 2 4 1 3 0 1 2 1 3 4 4 4
4 3 0 0 0 1 4 3 5 2 5 2 2 0 1 3 0 1 0 4 2 3 0 0 4 0 0 2 4 1 3 0 3 0 5 0 3 5 3 3
4 5 0 2 4 3 3 3 4 2 5 4 1 5 2 2 1 2 1 5 2 0 4 3 3 0 1 5 2 2 4 3 5 0 0 1 2 1 0 4

'layer ground2
1 4 4 2 4 4 4 3 1 5 4 4 1 3 2 4 1 5 2 0 3 5 5 2 3 1 2 1 4 1 4 5 4 1 0 3 1 1 4 1
2 1 1 2 0 2 5 2 2 2 4 5 3 2 2 2 1 1 0 0 4 1 2 4 0 1 5 1 1 4 1 4 3 5 2 4 5 3 5 4
0 0 0 3 1 1 3 3 3 2 1 4 0 2 5 3 1 1 1 2 2 1 5 2 5 1 1 1 0 4 0 4 3 5 0 3 2 1 5 3
5 2 5 1 0 5 4 5 3 4 1 4 3 4 0 4 1 0 5 0 5 4 3 0 0 2 5 1 3 4 4 1 4 1 5 0 5 0 0 2
1 0 3 2 7 14 2 13 0 1 1 5 0 3 4 3 5 4 3 5 4 1 2 3 4 2 0 2 1 3 1 0 0 0 0 5 4 0 2 1 3 5 4
0 3 0 5 8 15 0 12 2 3 0 0 3 5 4 5 4 0 2 5 4 4 4 2 0 2 2 1 2 0 5 5 3 0 0 5 0 5 2 2 3 1 2
0 0 5 0 9 10 11 2 5 2 1 0 2 1 2 3 0 5 3 2 3 0 4 0 1 3 4 2 3 0 3 5 5 1 2 3 1 3 1 3 2 3 0
5 0 5 4 0 4 0 4 4 4 2 5 4 2 4 4 2 0 0 5 4 1 1 5 5 2 2 2 1 2 3 3 4 4 5 4 0 2 5 0
4 1 2 0 1 2 0 4 0 2 1 4 0 5 2 1 4 3 3 0 5 0 5 5 0 0 4 2 2 1 0 0 0 4 2 4 1 1 2 0
1 1 0 2 2 5 2 5 1 4 4 2 2 4 2 1 1 5 4 2 0 0 3 5 4 0 0 2 5 4 1 2 5 5 5 5 1 3 2 1
3 5 1 3 1 3 3 2 5 3 0 2 0 5 4 1 0 1 3 3 5 2 5 2 1 2 3 3 3 0 0 5 1 3 5 0 4 1 5 1
3 2 0 0 4 4 4 0 0 1 4 4 4 5 0 3 1 4 4 2 2 5 3 3 4 3 5 5 2 2 4 4 5 4 5 2 0 2 4 0
2 1 5 0 1 1 1 2 1 0 2 5 3 5 5 2 4 0 1 0 2 2 4 0 4 4 5 2 2 1 3 3 3 4 2 3 3 0 4 3
4 2 4 0 2 5 2 5 1 0 5 5 5 1 5 3 2 4 2 1 0 2 1 5 4 0 5 4 4 3 2 4 5 4 2 2 3 0 2 0
3 3 2 1 0 1 0 1 1 4 5 0 4 1 0 2 2 2 1 0 2 5 2 4 3 3 0 0 4 2 1 5 1 1 2 2 4 1 5 5
3 1 4 3 1 2 3 4 2 1 1 5 2 4 0 1 4 4 3 0 2 1 0 1 0 1 0 0 1 0 1 4 3 0 4 4 0 1 1 0
4 1 1 1 5 3 0 3 0 3 2 0 3 3 1 4 2 4 3 1 3 0 3 4 0 0 5 0 0 0 0 2 0 0 3 4 3 4 4 3
5 1 3 5 2 3 0 0 5 1 0 5 2 5 5 0 1 0 1 4 3 2 3 5 1 5 2 1 0 0 4 5 5 5 2 2 1 5 4 3
0 1 5 3 0 2 2 3 3 2 4 3 1 1 2 1 0 3 5 4 1 5 3 1 2 3 4 1 1 4 5 3 2 4 5 2 4 4 5 4
5 0 4 5 1 1 3 1 2 5 1 4 4 5 3 5 2 2 4 1 5 1 5 3 0 5 4 3 2 4 4 4 1 2 4 0 3 0 4 4
0 1 4 3 0 1 4 1 4 0 5 5 2 5 4 4 2 0 1 5 2 0 4 0 3 3 3 5 3 2 5 3 4 4 0 5 4 1 5 3
1 1 2 1 3 5 3 2 1 1 4 4 4 0 5 3 4 3 0 5 5 3 5 4 1 5 3 5 4 0 5 4 3 1 4 4 3 1 4 4
3 5 5 4 1 1 2 5 3 2 5 2 4 4 0 0 5 1 5 0 4 2 0 0 4 3 2 1 3 3 0 4 2 2 0 4 5 5 5 0
2 0 5 2 0 4 0 2 5 3 1 1 4 2 0 5 1 0 3 2 1 0 5 2 0 4 3 4 4 1 4 1 0 5 4 1 2 3 1 3
2 4 3 1 2 5 4 5 2 3 1 5 0 0 0 2 5 3 5 1 5 5 0 3 2 4 5 0 2 4 5 0 2 1 5 0 5 2 1 4
2 1 3 3 1 3 3 0 2 4 4 3 0 1 1 5 5 2 1 3 4 1 3 3 5 3 2 4 5 4 3 2 0 4 3 2 4 3 4 0
3 1 4 0 5 0 1 3 1 3 0 5 4 0 0 3 0 2 5 5 5 1 5 2 2 0 2 3 5 5 3 4 3 5 1 4 4 0 4 0
2 2 0 4 5 4 1 1 3 4 5 3 5 3 2 0 4 3 2 5 3 5 0 3 5 5 4 1 1 5 2 0 3 0 1 5 5 1 2 3
1 5 4 1 4 4 1 1 4 2 1 5 2 4 3 1 0 5 5 5 1 2 3 2 4 4 3 4 3 1 5 0 0 1 2 4 0 4 4 4
4 0 0 5 4 2 2 3 4 0 3 4 5 5 0 5 1 5 1 5 2 3 3 4 0 2 4 0 5 1 2 0 0 4 2 4 5 2 2 5
2 5 5 5 4 2 0 1 1 3 0 4 4 0 4 0 5 1 4 3 4 5 4 0 1 0 1 1 4 0 5 0 4 1 5 4 3 0 1 4
1 4 3 3 0 4 1 0 2 0 3 1 2 2 5 3 1 1 2 0 2 2 3 4 5 1 1 4 1 4 1 3 4 4 3 3 5 4 2 1
3 0 5 1 0 5 3 5 3 2 0 2 2 5 3 1 0 4 4 2 5 0 4 0 4 0 0 2 2 2 5 2 4 1 1 1 1 2 4 2
2 0 0 4 3 2 0 1 2 2 3 0 5 1 4 5 2 0 3 1 1 0 3 2 0 3 3 2 4 3 4 1 3 0 4 3 0 5 0 3
1 0 5 5 0 0 3 4 2 5 3 2 3 4 1 2 3 0 3 4 1 4 1 5 5 5 3 5 0 1 1 0 4 0 3 2 2 3 3 1
3 4 4 2 2 5 4 0 3 2 2 1 5 5 3 4 5 0 2 2 0 4 3 2 5 2 0 0 1 5 3 3 0 5 1 0 2 3 2 1
5 0 5 0 4 4 3 5 1 0 0 3 0 1 0 5 1 0 2 1 0 3 0 4 1 4 3 5 3 4 2 1 5 3 3 5 3 5 3 3
1 3 0 4 5 1 0 0 2 1 0 5 5 5 4 1 4 3 1 4 4 5 4 1 1 3 5 3 5 5 2 1 3 4 0 1 4 2 2 0
0 2 0 2 2 1 2 0 5 5 3 5 1 2 4 4 1 4 0 3 1 2 3 2 3 2 0 3 2 3 5 5 2 1 4 0 5 2 0 2
1 5 4 3 4 3 3 1 1 0 1 1 0 1 3 3 0 1 3 2 1 5 4 5 3 3 5 3 5 1 2 3 5 1 5 1 4 5 4 0

'layer ground3
3 1 4 0 0 1 2 4 2 0 0 4 0 1 0 1 2 4 3 3 0 1 1 0 0 1 2 4 1 2 2 2 0 5 0 1 2 5 1 2
5 4 5 0 7 14 4 13 2 4 0 4 5 5 5 1 2 5 1 3 3 5 5 2 5 5 3 1 2 0 5 1 1 2 4 0 5 3 5 5 1 4 4
5 2 1 3 8 15 1 12 2 3 0 0 2 0 3 3 5 2 2 2 5 3 4 4 1 1 0 0 2 1 2 3 3 5 2 1 1 3 5 3 5 5 4
3 4 1 0 9 10 11 2 4 0 2 5 0 3 1 0 3 2 1 1 0 2 2 3 3 4 4 5 0 0 1 5 3 4 5 3 2 0 2 5 5 2 1
1 2 3 0 5 0 5 2 1 0 1 1 0 5 1 5 0 2 5 0 3 5 2 5 4 5 1 0 3 1 3 2 0 3 4 1 1 2 3 5
2 2 0 3 4 1 0 2 0 2 1 5 3 2 0 5 4 0 4 5 0 4 0 1 5 0 3 1 5 5 5 2 0 4 0 1 2 1 0 2
5 0 4 4 0 5 3 5 1 2 2 0 3 2 5 5 1 4 5 2 4 1 4 0 3 2 5 0 2 5 2 1 2 3 4 3 5 2 5 1
3 1 5 0 5 1 4 5 3 4 4 4 1 0 5 4 4 3 4 3 0 5 1 0 0 1 3 2 3 0 3 2 4 3 0 0 5 4 1 3
3 4 1 1 0 4 2 0 3 2 4 3 2 5 3 5 3 4 2 2 3 5 5 4 0 1 4 5 5 1 5 2 0 4 2 4 4 2 3 1
1 4 3 2 1 2 1 0 2 2 3 1 3 5 2 5 1 1 0 4 1 3 2 5 5 4 5 1 2 4 3 5 3 3 5 4 3 1 4 4
1 4 1 2 5 1 4 1 3 0 3 1 1 4 2 2 1 3 5 3 4 3 3 4 5 3 3 4 0 2 4 3 3 3 3 4 0 4 2 0
5 0 3 1 3 0 5 3 0 2 5 0 5 2 3 4 5 4 4 2 2 0 0 5 5 4 1 3 3 1 5 4 2 4 5 1 2 2 3 5
5 2 5 5 2 2 1 0 4 0 4 2 4 5 2 3 2 3 0 3 0 3 5 1 4 2 2 1 3 5 5 2 3 4 5 2 3 0 2 3
4 1 4 2 0 3 4 4 5 3 4 2 5 0 4 4 1 4 2 3 0 5 2 0 1 3 2 1 3 4 0 1 0 1 4 4 2 0 3 2
5 0 1 0 5 5 3 0 1 5 4 1 3 5 3 2 3 5 0 2 3 0 3 3 4 5 5 1 0 5 3 1 4 0 4 3 3 2 0 0
5 1 0 0 1 1 0 5 5 1 4 4 5 4 0 5 5 2 2 4 1 4 1 3 5 3 2 5 4 1 0 0 3 2 0 0 5 1 3 1
4 3 2 2 0 0 3 2 0 0 3 0 1 3 0 1 0 1 3 2 5 5 0 0 3 4 5 3 4 0 5 5 2 3 0 2 5 3 4 5
5 2 5 4 1 1 3 2 5 2 2 4 2 1 4 1 0 5 0 2 4 0 3 5 0 0 3 2 4 4 2 4 5 0 4 4 2 5 3 2
0 4 3 0 1 3 0 5 1 4 5 1 5 2 3 4 1 4 4 5 3 4 0 4 1 5 3 4 5 4 1 0 2 2 1 3 4 0 3 1
4 2 2 3 1 2 1 2 4 5 1 2 2 0 5 2 2 2 1 5 5 4 0 3 3 1 0 4 3 3 0 5 4 3 2 3 1 3 5 2
1 1 2 5 4 2 3 2 4 5 1 5 4 4 1 5 5 5 5 3 0 4 3 1 2 2 2 5 5 3 3 4 0 4 3 1 0 0 5 1
5 4 1 1 5 3 3 3 5 0 2 0 4 3 3 2 2 0 3 5 5 5 4 2 5 0 4 3 2 5 4 2 5 3 2 1 5 4 1 0
4 0 1 2 1 1 5 1 3 1 3 5 2 5 4 2 0 3 2 1 3 4 4 2 4 0 0 4 5 4 2 5 5 1 0 5 3 5 5 3
5 2 5 3 3 5 2 3 5 3 4 3 5 3 1 0 2 4 1 5 4 5 0 5 3 2 4 4 1 5 0 2 4 0 0 3 0 0 1 0
5 2 4 4 4 1 0 4 4 0 5 0 2 5 1 3 5 2 4 2 1 0 0 4 1 3 2 1 5 0 1 4 0 0 1 4 5 0 3 2
4 5 4 3 2 3 2 3 2 0 4 1 3 0 2 2 3 1 0 1 1 3 3 2 3 5 2 4 5 2 5 0 3 4 0 4 5 5 3 5
4 3 4 5 5 2 4 5 2 0 0 4 5 5 4 3 0 0 3 1 0 1 2 0 1 4 3 0 5 0 3 0 5 5 0 2 5 4 0 3
5 3 4 0 3 2 5 1 5 2 1 1 3 1 3 2 3 2 3 1 3 3 3 0 1 5 3 2 3 5 5 5 3 5 5 1 2 0 3 5
4 4 2 1 1 1 2 5 1 2 5 2 1 3 5 1 5 1 1 1 2 4 2 1 1 5 2 2 0 0 4 1 4 2 2 1 5 4 3 3
4 4 5 2 2 1 4 5 5 2 5 4 3 3 1 2 3 1 1 2 0 0 4 3 5 0 0 5 2 5 4 3 2 1 2 2 5 5 5 0
5 4 3 4 5 4 5 2 0 0 2 4 3 3 4 4 1 5 4 0 0 3 5 2 5 0 2 4 2 3 5 2 2 5 1 2 0 5 0 4
2 2 2 4 3 0 1 5 0 1 1 0 3 4 0 3 3 3 1 4 0 1 3 0 0 1 1 2 0 4 0 5 3 4 1 2 3 1 2 3
3 5 5 4 5 0 1 2 5 1 3 1 2 3 2 4 2 2 2 3 0 1 1 2 2 2 0 0 1 4 2 1 2 3 2 3 3 4 2 2
2 5 4 3 0 4 1 0 4 2 0 5 5 0 0 5 4 3 0 2 0 3 2 2 5 1 3 4 1 0 3 3 1 5 0 3 3 0 5 1
0 3 5 3 4 4 4 2 0 2 3 4 0 4 3 0 2 3 1 2 3 2 3 5 0 5 1 1 2 1 5 3 2 3 0 2 3 1 0 0
5 5 3 2 2 0 0 2 3 2 5 5 0 2 5 2 0 3 5 0 5 0 2 1 3 4 5 5 4 4 1 5 2 4 3 3 3 1 0 2
5 1 0 1 3 0 1 3 0 5 2 2 0 0 5 2 4 5 0 4 3 0 5 5 3 5 4 4 3 5 5 2 0 1 4 4 4 1 1 1
3 3 3 0 1 2 0 1 0 4 2 2 0 3 1 0 5 4 1 5 4 2 5 1 3 4 4 2 2 4 5 0 5 3 3 5 4 4 0 0
4 3 3 0 0 0 0 1 4 1 3 5 5 2 1 5 0 5 5 3 5 3 3 1 3 3 2 1 5 2 5 5 4 1 3 5 1 2 2 4
2 3 3 3 0 3 3 5 5 2 4 2 3 2 2 2 0 1 2 4 0 4 3 4 4 0 0 4 5 1 0 4 3 4 5 0 4 2 4 5

'layer players
90 90 93 94 93 90 92 94 93 93 94 90 92 91 93 90 93 94 93 93 90 90 94 94 90 93 90 93 90 94 91 90 92 92 92 91 92 91 94 93
91 91 93 92 91 94 93 90 91 90 94 93 90 90 91 94 92 92 92 90 91 91 93 92 94 90 91 94 93 92 94 93 92 92 92 91 94 93 90 94
92 94 94 91 91 92 90 92 90 91 94 90 94 90 92 92 94 92 90 93 93 93 91 94 91 93 93 94 90 91 91 93 90 91 93 91 93 94 94 91
91 94 94 90 90 92 91 94 93 92 93 93 91 91 92 90 93 93 91 93 92 93 94 93 91 92 90 92 94 91 90 90 91 94 90 90 92 90 91 91
91 93 92 94 93 92 90 94 90 90 93 90 91 90 90 90 91 91 93 92 93 91 94 92 90 90 93 92 90 93 92 92 94 90 91 92 91 91 90 93
91 91 90 94 94 92 90 94 90 92 94 91 94 91 92 93 91 90 93 93 92 94 94 94 94 90 93 90 92 93 90 92 93 94 94 93 91 92 92 92
91 91 93 90 91 93 94 93 93 90 91 93 90 92 94 91 92 90 91 93 92 91 93 94 94 94 91 92 90 91 90 90 90 93 92 92 92 93 91 94
94 93 93 92 92 90 91 90 90 94 91 90 90 91 94 91 92 94 93 90 90 94 91 93 93 90 91 93 93 94 90 94 93 92 92 90 93 94 90 92
93 94 92 91 91 92 93 92 93 93 91 91 92 90 91 93 94 93 91 90 90 90 94 90 94 94 94 93 94 92 90 94 91 92 94 91 93 93 90 91
92 94 91 91 91 93 93 90 94 91 90 91 90 90 91 90 90 92 93 94 94 94 91 90 94 90 91 93 92 92 90 93 93 91 93 91 90 90 91 93
93 92 94 91 91 91 94 94 94 90 91 91 92 90 90 94 91 92 93 93 90 94 90 91 91 93 91 90 91 91 91 92 90 92 92 91 91 93 94 93
92 94 91 93 90 93 93 91 94 92 93 90 94 91 92 91 92 90 90 92 92 94 92 91 94 91 94 93 90 91 94 92 91 94 94 93 93 94 92 90
93 94 93 92 91 91 91 94 94 92 94 94 91 93 91 92 90 92 92 91 90 93 90 94 93 94 93 94 93 90 90 91 93 92 91 94 94 94 91 94
91 92 94 93 90 92 92 90 90 92 90 93 91 93 92 92 90 93 93 92 91 91 91 93 90 92 90 91 92 92 94 94 94 93 93 92 93 94 93 92
93 92 92 91 91 92 93 90 94 90 94 94 90 93 90 94 93 91 94 90 91 93 92 91 92 94 92 90 94 93 93 92 91 92 90 92 94 90 90 94
91 91 92 94 92 94 90 93 93 92 92 94 91 90 92 94 93 91 91 94 91 93 91 90 92 94 90 90 91 91 93 90 93 93 90 94 92 91 90 92
91 91 91 92 93 93 90 90 90 91 91 93 91 92 92 92 90 94 90 90 93 94 91 93 91 91 90 94 93 94 93 94 90 94 90 90 90 93 94 94
91 93 92 90 93 92 92 90 93 90 94 90 93 94 90 90 90 93 91 91 90 93 90 91 93 93 91 92 94 92 90 93 92 91 90 92 94 90 93 94
92 94 92 93 91 90 93 90 92 92 93 94 93 93 94 92 92 92 91 93 90 94 91 93 90 92 90 94 93 93 94 92 91 94 91 94 90 91 90 90
92 90 92 91 90 93 91 90 93 94 92 93 93 94 90 94 94 91 93 92 91 93 90 91 93 90 93 92 91 90 90 90 90 91 90 92 91 94 90 93
94 91 93 91 94 94 94 90 90 91 91 91 93 93 91 92 92 94 94 94 90 90 94 90 90 93 90 94 92 94 90 93 90 94 93 94 94 90 92 91
93 94 90 90 92 93 92 94 90 93 91 94 91 94 92 93 93 92 94 94 92 90 93 94 94 94 92 91 91 92 93 94 94 90 90 93 91 93 92 91
90 90 92 93 90 92 91 92 91 93 94 93 91 92 94 93 93 93 92 91 94 92 90 91 94 93 93 92 90 91 91 90 94 93 93 90 92 92 90 94
92 93 94 90 93 94 93 92 93 92 90 93 91 91 93 93 90 93 94 94 94 94 91 90 94 94 91 93 93 93 90 91 94 91 93 93 91 90 91 90
90 92 91 94 91 92 92 90 92 90 90 90 94 92 93 90 93 93 91 94 91 92 94 90 94 93 92 92 90 92 91 93 93 92 94 93 94 94 92 92
92 92 94 93 94 92 92 90 91 91 93 92 93 90 93 91 90 90 91 94 90 94 92 93 90 94 93 90 93 91 93 93 94 93 94 92 90 94 90 91
90 90 91 94 93 90 94 94 94 94 93 91 92 90 90 94 90 92 92 94 94 92 94 91 93 92 90 90 91 94 93 92 92 90 94 90 93 92 90 94
90 92 92 92 93 94 93 92 94 91 91 91 90 93 93 91 93 94 93 90 90 94 94 93 90 93 94 90 94 91 94 90 94 94 92 94 90 94 91 90
93 93 93 92 94 92 90 90 90 93 90 93 91 91 90 93 91 90 91 91 91 93 91 92 90 94 92 94 94 93 90 94 93 90 94 93 92 91 90 91
91 94 90 94 94 91 92 92 91 90 93 94 92 92 90 92 91 92 92 93 91 92 91 93 92 93 94 92 90 91 93 91 93 90 90 92 90 91 94 91
93 91 94 94 94 90 93 94 91 93 93 90 91 93 90 94 91 91 94 92 92 94 90 90 94 93 92 93 91 92 91 93 90 92 94 94 91 91 94 92
90 93 94 90 90 94 91 93 91 90 92 94 92 92 90 93 92 90 91 93 91 93 93 90 92 94 92 92 91 91 90 92 93 92 92 93 93 90 93 92
93 90 94 94 94 94 93 92 91 90 90 94 91 93 92 93 93 91 93 94 92 91 92 93 93 91 94 93 94 90 90 90 93 91 92 93 92 94 94 94
91 91 90 93 92 94 93 94 90 91 94 93 94 90 92 92 90 90 94 92 92 93 90 91 93 90 91 92 93 91 91 93 90 92 94 93 94 92 93 91
94 90 92 90 91 91 94 93 94 93 93 94 94 93 91 92 92 92 92 91 92 94 91 94 94 93 94 90 93 93 94 91 90 93 90 92 94 92 90 92
94 93 90 91 93 91 93 92 94 94 92 94 91 92 93 90 90 91 91 92 92 92 94 93 92 93 94 93 90 90 93 94 93 90 91 92 92 90 93 90
94 92 91 93 90 94 94 93 92 94 91 91 92 94 90 90 94 93 93 90 93 94 90 91 90 94 92 93 91 94 91 93 90 92 91 90 91 92 90 94
90 91 91 92 90 90 90 90 91 91 94 94 90 92 92 92 93 90 91 94 91 94 91 94 92 90 91 94 93 90 91 90 92 94 91 94 92 92 90 94
93 91 93 93 94 90 93 93 93 92 91 94 94 90 92 94 91 91 94 90 94 92 94 92 92 93 92 92 93 94 92 94 90 94 94 90 90 93 91 91
92 94 92 90 90 92 91 94 94 93 90 92 90 90 92 93 92 92 90 90 93 91 93 93 92 94 93 91 91 93 92 94 90 92 92 91 91 91 94 90

'layer roofs
70 71 74 70 72 74 72 73 74 72 71 70 71 72 74 72 70 70 70 71 73 70 74 74 74 71 71 70 72 73 70 71 72 73 73 70 73 70 71 74
70 72 74 71 72 74 74 74 74 74 73 73 70 70 73 74 73 74 72 70 74 71 71 71 73 74 72 71 74 73 70 71 72 70 74 71 73 71 71 71
70 71 71 72 73 71 72 73 70 73 73 73 71 71 72 70 74 71 74 72 74 72 74 72 74 71 72 71 71 73 74 73 72 74 73 72 74 74 72 70
70 70 71 72 71 73 72 74 73 72 71 72 70 71 71 70 74 73 72 73 70 73 71 70 72 72 70 71 71 73 72 73 72 71 73 72 73 73 70 71
71 72 72 71 71 73 73 73 74 73 72 73 73 72 70 71 72 72 73 71 71 71 74 74 73 73 72 71 72 73 71 72 71 74 70 73 72 73 71 73
70 70 72 74 74 71 74 73 72 70 72 70 72 74 74 71 74 74 72 71 71 74 74 73 74 70 74 74 71 72 71 73 74 70 70 74 74 73 73 71
72 72 72 73 73 72 70 70 70 74 71 72 71 71 71 72 73 70 71 70 71 73 72 74 74 71 72 71 70 74 73 72 74 70 70 71 73 73 71 71
72 73 72 74 72 74 70 72 74 71 73 72 73 70 73 73 74 73 74 73 72 73 74 72 74 71 71 74 72 74 70 72 71 70 74 74 73 73 73 72
74 71 72 71 74 72 70 70 73 74 73 71 74 70 74 71 71 71 74 74 73 74 74 72 72 70 70 73 70 71 73 73 71 74 71 73 74 74 70 74
71 72 71 70 71 73 71 71 70 71 71 72 74 70 70 74 72 72 74 70 74 73 71 70 72 73 70 74 72 74 70 72 73 70 71 74 74 70 70 72
71 73 71 73 73 72 74 74 73 71 74 71 72 71 73 73 71 73 73 72 71 74 70 74 74 73 72 74 72 71 72 70 70 70 71 72 74 71 71 74
74 73 74 74 74 71 72 73 74 73 72 74 72 74 72 73 74 71 74 72 70 72 74 71 73 70 71 73 74 73 71 72 74 74 72 71 73 70 71 74
70 71 73 71 74 72 73 72 71 70 71 71 70 73 71 73 74 74 71 70 71 70 73 72 73 73 70 73 71 70 72 70 73 74 74 71 71 74 72 70
73 74 74 70 74 72 73 74 72 70 70 73 70 74 71 70 74 71 71 73 73 70 73 73 74 70 71 72 74 72 71 70 74 72 70 71 71 70 73 72
70 71 70 71 74 73 73 70 71 72 71 70 72 70 70 73 73 70 70 74 72 73 71 73 70 70 71 70 73 73 74 70 72 74 73 70 74 71 71 71
70 70 70 71 70 70 74 70 71 71 70 71 73 70 72 70 71 70 71 74 73 72 71 73 74 70 71 72 72 73 71 70 72 72 72 71 73 74 73 74
72 73 70 70 70 70 70 70 71 72 72 70 71 73 71 72 74 74 71 71 71 74 72 73 74 72 71 73 73 74 70 72 72 70 73 71 73 73 73 72
72 70 74 71 73 71 71 71 70 72 73 73 70 72 73 72 71 74 72 71 70 74 74 72 74 71 71 74 74 70 73 74 74 70 73 74 71 72 71 73
73 74 73 74 71 70 73 71 72 72 72 73 73 72 71 71 72 72 70 74 74 70 72 72 72 72 72 72 71 70 72 71 70 71 70 70 74 70 70 72
73 73 73 71 73 74 72 73 71 74 71 71 73 70 72 71 71 72 72 73 74 70 74 72 74 70 74 72 72 73 70 72 73 71 71 70 73 71 74 73
74 73 70 73 70 72 73 73 73 71 70 71 73 70 70 73 70 70 72 74 71 74 74 72 73 72 71 74 70 70 72 72 71 74 74 71 72 73 70 74
71 72 71 72 72 71 72 73 72 72 74 70 71 71 72 72 72 71 70 72 70 73 70 73 73 70 73 73 74 70 70 73 70 72 74 74 72 73 72 70
71 74 70 74 71 72 72 71 71 70 74 72 74 73 74 73 71 74 70 73 71 72 72 74 74 71 71 72 73 72 72 71 71 72 74 74 71 72 71 73
72 74 72 70 71 74 70 71 72 71 74 72 70 72 73 74 73 72 74 73 73 73 72 71 71 74 70 73 74 71 72 73 72 72 72 70 71 74 70 74
72 73 70 71 72 74 71 70 74 73 72 73 71 70 72 73 73 70 71 70 72 74 70 72 73 71 71 72 73 70 70 73 73 71 70 71 70 72 70 74
73 73 72 72 74 71 71 74 73 72 70 74 73 73 70 74 72 70 73 73 74 73 74 72 72 70 74 70 70 71 70 74 72 74 71 72 73 71 71 72
70 70 74 74 73 72 72 70 70 70 71 73 73 73 70 70 74 72 72 71 71 72 71 70 73 74 72 74 73 73 73 72 73 73 70 73 70 71 74 71
71 70 73 71 71 70 74 71 70 71 74 70 71 71 74 74 73 72 72 70 73 70 72 74 74 71 70 70 74 71 74 72 70 70 73 73 73 74 74 73
72 73 71 74 71 71 73 70 73 71 74 70 71 70 74 73 72 74 70 72 72 73 70 74 72 72 73 73 72 72 72 71 71 70 71 74 72 71 74 70
70 74 70 73 70 70 72 73 74 72 74 70 72 73 70 73 74 73 70 72 70 70 72 73 74 70 70 71 71 72 71 74 70 73 74 73 71 70 71 71
74 74 70 72 72 70 73 72 71 73 71 74 71 70 70 74 70 74 70 74 72 74 71 72 73 72 74 73 74 73 70 70 71 73 71 73 71 73 71 72
71 74 71 74 73 71 72 73 73 71 70 74 74 72 74 70 73 73 74 72 72 72 73 71 74 71 73 74 74 70 73 73 71 71 73 72 72 71 73 70
71 70 74 73 72 72 70 72 71 74 74 71 71 73 72 74 71 71 73 74 74 72 73 72 71 72 74 74 72 74 72 71 74 72 74 70 70 72 74 74
74 73 73 74 70 72 71 71 71 72 73 72 72 71 73 73 72 70 73 71 70 73 72 74 72 70 70 73 71 70 70 71 71 71 70 71 70 73 73 72
73 71 71 73 74 73 70 74 73 74 73 70 73 74 74 72 73 74 71 70 73 74 72 73 73 70 70 70 72 73 73 70 72 72 73 70 72 72 71 74
73 73 71 73 71 71 72 73 71 70 74 73 73 74 74 73 74 71 70 70 74 73 74 73 72 72 73 71 72 71 70 73 71 70 74 70 74 71 74 72
74 72 71 70 71 73 74 73 70 74 74 73 71 71 73 73 74 74 74 74 70 74 71 70 71 73 74 71 73 72 71 73 73 73 70 74 70 73 72 71
74 72 72 73 70 72 71 72 73 73 72 73 71 71 70 72 74 73 73 72 70 72 70 74 74 72 73 71 72 71 71 71 73 71 70 74 73 71 70 73
72 72 71 71 73 74 73 72 71 72 73 72 71 74 71 72 73 73 73 73 70 74 71 74 72 72 71 70 74 74 72 73 74 72 71 70 71 71 73 73
70 74 72 73 74 73 73 70 73 70 71 73 74 70 71 72 70 72 71 72 70 71 70 70 72 71 73 71 71 74 74 73 71 71 74 70 73 73 74 74

'layer plants
50 53 50 52 51 54 51 50 52 54 50 50 51 52 51 50 52 53 51 52 54 50 51 53 53 50 54 52 53 54 54 52 54 53 51 51 54 54 51 52
53 51 51 50 53 53 52 51 54 52 50 52 50 54 50 53 52 52 50 52 53 51 50 50 53 53 51 54 51 52 54 52 52 54 51 53 50 52 54 50
52 51 53 53 52 53 50 52 50 53 53 53 53 54 51 51 51 51 52 50 50 50 54 50 54 51 51 54 54 50 54 51 53 54 52 51 51 51 50 54
50 52 53 53 52 50 53 54 50 54 53 51 52 53 50 50 52 50 52 54 50 50 53 53 52 50 52 51 50 54 52 52 51 54 52 53 54 50 53 52
54 52 51 54 50 53 51 54 54 53 52 52 51 53 54 54 50 54 50 51 50 51 52 50 53 53 52 54 51 50 54 52 50 50 50 53 53 53 54 51
50 50 52 50 54 51 51 51 52 52 51 53 53 52 53 50 50 53 50 51 54 51 53 53 52 54 53 51 50 52 53 53 54 53 50 51 52 50 51 51
54 54 52 50 50 53 52 51 53 50 53 51 53 52 53 51 50 51 52 50 54 53 53 51 53 52 54 50 53 51 50 52 51 53 53 51 53 52 51 50
50 51 52 51 51 51 52 51 50 50 52 53 54 52 50 53 54 52 53 50 53 51 50 51 54 52 54 54 53 53 51 54 53 50 52 53 54 51 54 51
52 50 54 53 52 53 51 51 54 53 50 52 53 51 50 53 50 53 53 50 52 53 51 50 52 54 50 52 50 54 50 53 50 52 50 50 51 53 53 54
53 52 53 50 54 51 54 50 53 51 51 51 54 51 51 52 52 51 54 52 53 50 54 50 53 54 53 52 54 53 52 51 52 53 50 52 53 52 52 50
51 53 51 51 52 54 50 50 51 50 54 53 54 52 51 53 54 54 51 52 51 53 50 50 54 50 53 54 51 53 51 54 52 54 54 53 52 51 51 53
53 50 51 52 50 54 52 52 51 51 52 50 54 54 50 54 50 53 50 51 53 50 54 54 53 52 50 51 54 50 52 50 51 53 54 53 51 53 54 53
50 52 51 52 53 53 53 50 54 52 54 50 54 52 53 50 51 51 52 50 53 51 50 52 53 52 50 53 53 50 53 54 51 54 51 50 54 50 51 50
53 53 52 50 54 53 53 51 53 53 53 51 51 53 51 50 52 53 51 53 52 51 50 54 50 52 54 50 51 53 53 50 54 52 53 52 54 51 52 50
52 50 51 50 53 53 51 53 54 50 52 51 51 52 52 51 54 53 52 54 50 51 50 53 53 54 54 53 52 50 51 54 50 52 53 53 53 50 54 50
53 51 53 54 54 53 50 52 52 51 53 51 52 54 53 53 53 53 51 51 54 54 52 52 52 50 53 54 54 53 54 50 52 54 51 54 54 54 51 50
53 53 51 50 54 53 51 53 51 52 52 53 52 53 54 51 50 52 52 54 52 53 53 52 52 51 53 54 53 53 51 53 52 53 53 52 51 53 53 51
52 52 52 50 53 52 53 53 54 54 50 52 51 53 51 51 54 54 54 50 52 53 53 52 50 51 54 51 52 51 53 50 50 53 52 53 53 52 51 52
50 54 52 51 50 51 53 54 50 53 51 53 53 52 51 52 52 54 54 51 53 52 54 54 54 52 53 53 52 51 52 52 53 51 53 52 51 52 53 54
51 50 52 53 54 52 50 50 53 50 51 50 54 54 54 51 54 51 54 50 51 54 52 53 53 53 54 54 53 54 51 52 54 52 50 50 52 54 54 51
54 50 52 53 53 53 54 53 50 50 50 54 50 54 50 50 50 53 50 54 52 51 54 54 52 50 50 51 50 51 50 51 50 53 54 50 52 54 54 53
51 53 52 51 50 51 53 53 54 50 54 50 52 53 51 50 54 50 51 54 50 53 54 52 51 53 53 51 50 53 51 51 51 51 53 51 51 54 54 53
50 53 50 54 51 50 54 54 50 50 54 50 50 53 52 51 51 51 52 52 53 53 51 54 53 52 50 53 52 51 50 52 51 50 53 54 52 50 52 54
51 53 54 52 54 51 51 52 50 53 53 51 54 52 54 52 52 52 50 51 51 50 53 52 54 53 50 51 54 54 52 54 51 50 50 51 52 50 51 52
53 51 51 50 52 53 51 52 50 52 54 51 54 54 54 53 54 53 50 51 54 54 50 53 54 53 54 51 51 52 54 53 50 51 50 53 53 54 54 50
52 52 54 52 52 51 52 53 53 54 51 54 51 54 51 50 51 51 50 53 54 50 53 51 54 53 51 51 50 52 54 54 54 53 50 53 54 54 54 50
51 50 53 50 50 52 51 52 53 50 52 52 54 53 51 52 54 54 52 54 53 53 50 53 53 51 54 51 52 53 52 51 50 54 54 52 54 54 51 54
54 52 54 51 54 54 51 50 53 50 54 51 54 52 51 53 50 50 53 53 54 52 53 51 53 53 53 52 51 53 50 53 54 54 51 54 54 51 52 52
53 50 52 53 52 53 52 51 53 51 51 52 54 53 52 54 52 54 50 54 50 53 50 50 50 52 53 54 53 54 51 51 54 54 53 53 51 50 50 52
51 54 51 54 54 51 52 52 51 52 54 52 54 51 54 50 50 51 52 52 51 54 52 54 53 51 50 53 52 54 50 53 53 51 54 51 50 53 53 53
53 54 51 54 54 52 52 54 51 54 53 51 51 52 51 50 50 54 51 53 54 51 54 51 50 50 50 52 54 54 53 50 50 52 50 51 53 50 50 51
53 51 50 52 50 53 51 50 52 51 50 50 52 53 52 52 51 53 54 50 52 50 51 50 50 54 51 53 50 52 52 50 50 51 52 51 54 53 51 50
54 54 53 51 54 51 51 54 53 54 54 53 51 51 51 52 54 50 54 53 50 52 53 54 50 53 53 51 50 54 54 52 53 54 54 50 53 54 52 50
52 50 52 54 50 51 54 53 52 51 52 50 53 54 54 50 51 52 54 53 53 50 54 52 53 54 50 52 54 50 52 54 51 52 52 51 50 54 50 50
53 54 54 53 54 53 54 52 53 54 52 54 52 53 54 51 51 52 52 52 53 50 54 54 52 50 52 54 51 50 51 53 52 54 52 51 51 52 52 52
51 52 52 50 54 50 54 50 54 50 54 53 52 54 54 52 53 52 50 50 51 50 52 51 53 52 52 50 54 51 54 51 52 52 50 51 53 51 50 52
54 52 51 53 50 54 50 54 53 50 51 50 52 51 52 54 53 54 52 53 50 50 53 54 53 51 50 53 54 53 52 53 53 52 54 51 51 50 54 50
54 54 50 53 54 52 54 50 54 52 52 53 53 51 50 54 50 52 52 52 54 52 54 51 53 53 52 54 53 51 51 54 53 51 53 50 54 53 53 53
50 54 52 54 54 54 52 52 50 51 53 52 53 54 54 53 52 53 54 54 50 51 54 51 53 50 54 51 53 52 53 53 52 51 50 51 50 54 53 50
54 50 51 52 53 51 51 54 53 51 50 51 51 52 52 51 52 54 54 52 53 53 54 53 54 54 51 54 50 53 51 50 53 54 53 53 52 52 52 53

